data,area,nuovi_vaccinati,sesso_maschile,sesso_femminile,operatori_sanitari,personale_non_sanitario,ospiti_rsa,over80,prima_dose,seconda_dose,vaccinati_totale,sesso_maschile_totale,sesso_femminile_totale,operatori_sanitari_totale,personale_non_sanitario_totale,ospiti_rsa_totale,over80_totale,prima_dose_totale,seconda_dose_totale
2020-12-27,ABR,37,19,18,34,1,2,0,37,0,37,19,18,34,1,2,0,37,0
2021-01-02,ABR,548,218,330,540,8,0,0,548,0,585,237,348,574,9,2,0,585,0
2021-01-03,ABR,471,185,286,464,7,0,0,471,0,1056,422,634,1038,16,2,0,1056,0
2021-01-04,ABR,1401,575,826,1396,5,0,0,1401,0,2457,997,1460,2434,21,2,0,2457,0
2021-01-05,ABR,1614,604,1010,1604,10,0,0,1614,0,4071,1601,2470,4038,31,2,0,4071,0
2021-01-06,ABR,1830,664,1166,1546,151,133,0,1830,0,5901,2265,3636,5584,182,135,0,5901,0
2021-01-07,ABR,1603,552,1051,1566,37,0,0,1603,0,7504,2817,4687,7150,219,135,0,7504,0
2021-01-08,ABR,1525,507,1018,1487,38,0,0,1525,0,9029,3324,5705,8637,257,135,0,9029,0
2021-01-09,ABR,1483,565,918,1430,53,0,0,1483,0,10512,3889,6623,10067,310,135,0,10512,0
2021-01-10,ABR,1139,409,730,1091,48,0,0,1139,0,11651,4298,7353,11158,358,135,0,11651,0
2021-01-11,ABR,1551,557,994,1337,166,48,0,1551,0,13202,4855,8347,12495,524,183,0,13202,0
2021-01-12,ABR,1804,666,1138,1470,334,0,0,1804,0,15006,5521,9485,13965,858,183,0,15006,0
2021-01-13,ABR,1253,440,813,1103,150,0,0,1253,0,16259,5961,10298,15068,1008,183,0,16259,0
2021-01-14,ABR,530,189,341,364,166,0,0,530,0,16789,6150,10639,15432,1174,183,0,16789,0
2021-01-15,ABR,379,149,230,223,121,35,0,379,0,17168,6299,10869,15655,1295,218,0,17168,0
2021-01-16,ABR,587,239,348,449,123,15,0,587,0,17755,6538,11217,16104,1418,233,0,17755,0
2021-01-17,ABR,187,59,128,136,51,0,0,180,7,17942,6597,11345,16240,1469,233,0,17935,7
2021-01-18,ABR,122,48,74,106,14,2,0,46,76,18064,6645,11419,16346,1483,235,0,17981,83
2021-01-19,ABR,111,55,56,27,34,50,0,91,20,18175,6700,11475,16373,1517,285,0,18072,103
2021-01-20,ABR,447,156,291,147,96,204,0,445,2,18622,6856,11766,16520,1613,489,0,18517,105
2021-01-21,ABR,157,47,110,10,6,141,0,157,0,18779,6903,11876,16530,1619,630,0,18674,105
2021-01-22,ABR,118,57,61,2,4,112,0,118,0,18897,6960,11937,16532,1623,742,0,18792,105
2021-01-23,ABR,263,114,149,223,14,26,0,57,206,19160,7074,12086,16755,1637,768,0,18849,311
2021-01-24,ABR,50,22,28,49,1,0,0,6,44,19210,7096,12114,16804,1638,768,0,18855,355
2021-01-25,ABR,1603,632,971,1583,20,0,0,20,1583,20813,7728,13085,18387,1658,768,0,18875,1938
2021-01-26,ABR,1536,565,971,1507,29,0,0,26,1510,22349,8293,14056,19894,1687,768,0,18901,3448
2021-01-27,ABR,457,192,265,424,33,0,0,3,454,22806,8485,14321,20318,1720,768,0,18904,3902
2020-12-27,BAS,106,41,65,104,2,0,0,106,0,106,41,65,104,2,0,0,106,0
2021-01-02,BAS,937,377,560,837,100,0,0,937,0,1043,418,625,941,102,0,0,1043,0
2021-01-03,BAS,900,344,556,787,113,0,0,900,0,1943,762,1181,1728,215,0,0,1943,0
2021-01-04,BAS,607,271,336,527,80,0,0,607,0,2550,1033,1517,2255,295,0,0,2550,0
2021-01-05,BAS,942,406,536,707,235,0,0,942,0,3492,1439,2053,2962,530,0,0,3492,0
2021-01-06,BAS,292,127,165,138,118,36,0,292,0,3784,1566,2218,3100,648,36,0,3784,0
2021-01-07,BAS,639,317,322,279,331,29,0,639,0,4423,1883,2540,3379,979,65,0,4423,0
2021-01-08,BAS,556,220,336,256,240,60,0,556,0,4979,2103,2876,3635,1219,125,0,4979,0
2021-01-09,BAS,556,161,395,279,210,67,0,556,0,5535,2264,3271,3914,1429,192,0,5535,0
2021-01-10,BAS,77,24,53,9,68,0,0,77,0,5612,2288,3324,3923,1497,192,0,5612,0
2021-01-11,BAS,182,65,117,78,63,41,0,182,0,5794,2353,3441,4001,1560,233,0,5794,0
2021-01-12,BAS,215,87,128,38,79,98,0,215,0,6009,2440,3569,4039,1639,331,0,6009,0
2021-01-13,BAS,913,384,529,573,192,148,0,913,0,6922,2824,4098,4612,1831,479,0,6922,0
2021-01-14,BAS,967,412,555,400,246,321,0,967,0,7889,3236,4653,5012,2077,800,0,7889,0
2021-01-15,BAS,811,349,462,449,190,172,0,811,0,8700,3585,5115,5461,2267,972,0,8700,0
2021-01-16,BAS,722,303,419,265,296,161,0,722,0,9422,3888,5534,5726,2563,1133,0,9422,0
2021-01-17,BAS,323,131,192,93,177,53,0,321,2,9745,4019,5726,5819,2740,1186,0,9743,2
2021-01-18,BAS,457,156,301,359,56,42,0,358,99,10202,4175,6027,6178,2796,1228,0,10101,101
2021-01-19,BAS,200,84,116,81,74,45,0,200,0,10402,4259,6143,6259,2870,1273,0,10301,101
2021-01-20,BAS,84,22,62,0,84,0,0,84,0,10486,4281,6205,6259,2954,1273,0,10385,101
2021-01-21,BAS,30,10,20,0,30,0,0,30,0,10516,4291,6225,6259,2984,1273,0,10415,101
2021-01-22,BAS,66,24,42,6,60,0,0,66,0,10582,4315,6267,6265,3044,1273,0,10481,101
2021-01-23,BAS,704,297,407,479,224,1,0,33,671,11286,4612,6674,6744,3268,1274,0,10514,772
2021-01-24,BAS,830,299,531,598,231,1,0,58,772,12116,4911,7205,7342,3499,1275,0,10572,1544
2021-01-25,BAS,1018,426,592,660,357,1,0,74,944,13134,5337,7797,8002,3856,1276,0,10646,2488
2021-01-26,BAS,792,350,442,478,279,35,0,99,693,13926,5687,8239,8480,4135,1311,0,10745,3181
2021-01-27,BAS,273,127,146,73,197,3,0,40,233,14199,5814,8385,8553,4332,1314,0,10785,3414
2020-12-27,CAL,274,147,127,272,2,0,0,274,0,274,147,127,272,2,0,0,274,0
2020-12-28,CAL,5,2,3,5,0,0,0,5,0,279,149,130,277,2,0,0,279,0
2021-01-02,CAL,169,97,72,169,0,0,0,169,0,448,246,202,446,2,0,0,448,0
2021-01-03,CAL,5,3,2,4,1,0,0,5,0,453,249,204,450,3,0,0,453,0
2021-01-04,CAL,1088,536,552,1038,50,0,0,1088,0,1541,785,756,1488,53,0,0,1541,0
2021-01-05,CAL,1575,745,830,1429,146,0,0,1575,0,3116,1530,1586,2917,199,0,0,3116,0
2021-01-06,CAL,1074,547,527,1014,60,0,0,1074,0,4190,2077,2113,3931,259,0,0,4190,0
2021-01-07,CAL,2880,1426,1454,2579,301,0,0,2880,0,7070,3503,3567,6510,560,0,0,7070,0
2021-01-08,CAL,1290,632,658,1171,119,0,0,1290,0,8360,4135,4225,7681,679,0,0,8360,0
2021-01-09,CAL,1781,896,885,1540,241,0,0,1781,0,10141,5031,5110,9221,920,0,0,10141,0
2021-01-10,CAL,1096,566,530,826,270,0,0,1096,0,11237,5597,5640,10047,1190,0,0,11237,0
2021-01-11,CAL,1544,791,753,1230,270,44,0,1544,0,12781,6388,6393,11277,1460,44,0,12781,0
2021-01-12,CAL,1292,624,668,1089,184,19,0,1292,0,14073,7012,7061,12366,1644,63,0,14073,0
2021-01-13,CAL,1444,706,738,1231,213,0,0,1444,0,15517,7718,7799,13597,1857,63,0,15517,0
2021-01-14,CAL,1956,967,989,1579,357,20,0,1956,0,17473,8685,8788,15176,2214,83,0,17473,0
2021-01-15,CAL,1555,720,835,1235,289,31,0,1555,0,19028,9405,9623,16411,2503,114,0,19028,0
2021-01-16,CAL,1127,548,579,978,131,18,0,1127,0,20155,9953,10202,17389,2634,132,0,20155,0
2021-01-17,CAL,398,198,200,235,121,42,0,362,36,20553,10151,10402,17624,2755,174,0,20517,36
2021-01-18,CAL,1056,475,581,843,202,11,0,866,190,21609,10626,10983,18467,2957,185,0,21383,226
2021-01-19,CAL,1088,482,606,832,180,76,0,1078,10,22697,11108,11589,19299,3137,261,0,22461,236
2021-01-20,CAL,1193,520,673,716,298,179,0,1192,1,23890,11628,12262,20015,3435,440,0,23653,237
2021-01-21,CAL,958,444,514,735,108,115,0,929,29,24848,12072,12776,20750,3543,555,0,24582,266
2021-01-22,CAL,637,262,375,298,248,91,0,635,2,25485,12334,13151,21048,3791,646,0,25217,268
2021-01-23,CAL,364,165,199,303,38,23,0,323,41,25849,12499,13350,21351,3829,669,0,25540,309
2021-01-24,CAL,44,18,26,15,3,26,0,39,5,25893,12517,13376,21366,3832,695,0,25579,314
2021-01-25,CAL,1023,489,534,982,41,0,0,132,891,26916,13006,13910,22348,3873,695,0,25711,1205
2021-01-26,CAL,1717,823,894,1523,162,32,0,218,1499,28633,13829,14804,23871,4035,727,0,25929,2704
2021-01-27,CAL,265,145,120,221,44,0,0,8,257,28898,13974,14924,24092,4079,727,0,25937,2961
2020-12-27,CAM,720,422,298,703,17,0,0,720,0,720,422,298,703,17,0,0,720,0
2020-12-31,CAM,1490,811,679,1273,216,1,0,1490,0,2210,1233,977,1976,233,1,0,2210,0
2021-01-01,CAM,919,506,413,831,88,0,0,919,0,3129,1739,1390,2807,321,1,0,3129,0
2021-01-02,CAM,3674,1963,1711,3167,507,0,0,3674,0,6803,3702,3101,5974,828,1,0,6803,0
2021-01-03,CAM,3834,2008,1826,3190,644,0,0,3834,0,10637,5710,4927,9164,1472,1,0,10637,0
2021-01-04,CAM,5824,2961,2863,4849,975,0,0,5824,0,16461,8671,7790,14013,2447,1,0,16461,0
2021-01-05,CAM,7198,3618,3580,5779,1321,98,0,7198,0,23659,12289,11370,19792,3768,99,0,23659,0
2021-01-06,CAM,7651,3746,3905,5779,1572,300,0,7651,0,31310,16035,15275,25571,5340,399,0,31310,0
2021-01-07,CAM,8893,4157,4736,6304,2258,331,0,8893,0,40203,20192,20011,31875,7598,730,0,40203,0
2021-01-08,CAM,10451,4966,5485,6712,3527,212,0,10451,0,50654,25158,25496,38587,11125,942,0,50654,0
2021-01-09,CAM,10562,5023,5539,6758,3535,269,0,10562,0,61216,30181,31035,45345,14660,1211,0,61216,0
2021-01-10,CAM,8164,3739,4425,5178,2889,97,0,8164,0,69380,33920,35460,50523,17549,1308,0,69380,0
2021-01-11,CAM,4062,1863,2199,2379,1436,247,0,4062,0,73442,35783,37659,52902,18985,1555,0,73442,0
2021-01-12,CAM,5212,2562,2650,3438,1434,340,0,5212,0,78654,38345,40309,56340,20419,1895,0,78654,0
2021-01-13,CAM,7992,3650,4342,4335,3080,577,0,7992,0,86646,41995,44651,60675,23499,2472,0,86646,0
2021-01-14,CAM,7060,2978,4082,3693,3022,345,0,7060,0,93706,44973,48733,64368,26521,2817,0,93706,0
2021-01-15,CAM,4979,2384,2595,2744,2038,197,0,4979,0,98685,47357,51328,67112,28559,3014,0,98685,0
2021-01-16,CAM,3377,1674,1703,1360,1646,371,0,3377,0,102062,49031,53031,68472,30205,3385,0,102062,0
2021-01-17,CAM,1155,551,604,718,286,151,0,702,453,103217,49582,53635,69190,30491,3536,0,102764,453
2021-01-18,CAM,943,400,543,577,193,173,0,699,244,104160,49982,54178,69767,30684,3709,0,103463,697
2021-01-19,CAM,1095,473,622,535,389,171,0,1092,3,105255,50455,54800,70302,31073,3880,0,104555,700
2021-01-20,CAM,1257,650,607,395,761,101,0,1257,0,106512,51105,55407,70697,31834,3981,0,105812,700
2021-01-21,CAM,2091,1114,977,1378,638,75,0,676,1415,108603,52219,56384,72075,32472,4056,0,106488,2115
2021-01-22,CAM,1397,699,698,968,344,85,0,549,848,110000,52918,57082,73043,32816,4141,0,107037,2963
2021-01-23,CAM,3836,2028,1808,3161,607,68,0,272,3564,113836,54946,58890,76204,33423,4209,0,107309,6527
2021-01-24,CAM,4127,2122,2005,3140,821,166,0,383,3744,117963,57068,60895,79344,34244,4375,0,107692,10271
2021-01-25,CAM,5742,2926,2816,4741,945,56,0,165,5577,123705,59994,63711,84085,35189,4431,0,107857,15848
2021-01-26,CAM,7291,3699,3592,5737,1332,222,0,352,6939,130996,63693,67303,89822,36521,4653,0,108209,22787
2021-01-27,CAM,6771,3328,3443,5064,1470,237,0,115,6656,137767,67021,70746,94886,37991,4890,0,108324,29443
2020-12-27,EMR,964,373,591,679,259,26,0,964,0,964,373,591,679,259,26,0,964,0
2020-12-31,EMR,2116,748,1368,1571,247,298,0,2116,0,3080,1121,1959,2250,506,324,0,3080,0
2021-01-02,EMR,2271,890,1381,2037,84,150,0,2271,0,5351,2011,3340,4287,590,474,0,5351,0
2021-01-03,EMR,2732,937,1795,2370,192,170,0,2732,0,8083,2948,5135,6657,782,644,0,8083,0
2021-01-04,EMR,7232,2508,4724,5518,1167,547,0,7232,0,15315,5456,9859,12175,1949,1191,0,15315,0
2021-01-05,EMR,9078,3096,5982,6532,1886,660,0,9078,0,24393,8552,15841,18707,3835,1851,0,24393,0
2021-01-06,EMR,8157,2911,5246,5725,1834,598,0,8157,0,32550,11463,21087,24432,5669,2449,0,32550,0
2021-01-07,EMR,9841,3286,6555,6784,2214,843,0,9841,0,42391,14749,27642,31216,7883,3292,0,42391,0
2021-01-08,EMR,10415,3452,6963,7082,2426,907,0,10415,0,52806,18201,34605,38298,10309,4199,0,52806,0
2021-01-09,EMR,9336,3262,6074,6255,2455,626,0,9336,0,62142,21463,40679,44553,12764,4825,0,62142,0
2021-01-10,EMR,6857,2570,4287,4366,2164,327,0,6857,0,68999,24033,44966,48919,14928,5152,0,68999,0
2021-01-11,EMR,9067,3211,5856,5164,2886,1017,0,9067,0,78066,27244,50822,54083,17814,6169,0,78066,0
2021-01-12,EMR,9243,3057,6186,5163,2562,1518,0,9243,0,87309,30301,57008,59246,20376,7687,0,87309,0
2021-01-13,EMR,8940,2887,6053,4677,2699,1564,0,8940,0,96249,33188,63061,63923,23075,9251,0,96249,0
2021-01-14,EMR,7979,2534,5445,4151,2387,1441,0,7979,0,104228,35722,68506,68074,25462,10692,0,104228,0
2021-01-15,EMR,7118,2230,4888,4037,2077,1004,0,7118,0,111346,37952,73394,72111,27539,11696,0,111346,0
2021-01-16,EMR,5202,1621,3581,2904,1603,695,0,5195,7,116548,39573,76975,75015,29142,12391,0,116541,7
2021-01-17,EMR,2687,851,1836,1526,883,278,0,2438,249,119235,40424,78811,76541,30025,12669,0,118979,256
2021-01-18,EMR,2574,770,1804,1320,635,619,0,1922,652,121809,41194,80615,77861,30660,13288,0,120901,908
2021-01-19,EMR,1600,376,1224,569,152,879,0,1582,18,123409,41570,81839,78430,30812,14167,0,122483,926
2021-01-20,EMR,795,155,640,220,89,486,0,794,1,124204,41725,82479,78650,30901,14653,0,123277,927
2021-01-21,EMR,1542,569,973,977,154,411,0,406,1136,125746,42294,83452,79627,31055,15064,0,123683,2063
2021-01-22,EMR,1523,409,1114,879,172,472,0,783,740,127269,42703,84566,80506,31227,15536,0,124466,2803
2021-01-23,EMR,2082,779,1303,1802,94,186,0,290,1792,129351,43482,85869,82308,31321,15722,0,124756,4595
2021-01-24,EMR,2220,822,1398,2055,123,42,0,108,2112,131571,44304,87267,84363,31444,15764,0,124864,6707
2021-01-25,EMR,5463,1837,3626,4336,604,523,0,159,5304,137034,46141,90893,88699,32048,16287,0,125023,12011
2021-01-26,EMR,7395,2699,4696,5562,964,869,0,212,7183,144429,48840,95589,94261,33012,17156,0,125235,19194
2021-01-27,EMR,7757,2729,5028,6248,1080,429,0,318,7439,152186,51569,100617,100509,34092,17585,0,125553,26633
2020-12-27,FVG,262,149,113,259,3,0,0,262,0,262,149,113,259,3,0,0,262,0
2020-12-30,FVG,630,246,384,601,29,0,0,630,0,892,395,497,860,32,0,0,892,0
2020-12-31,FVG,1053,384,669,1011,42,0,0,1053,0,1945,779,1166,1871,74,0,0,1945,0
2021-01-02,FVG,1217,471,746,1150,67,0,0,1217,0,3162,1250,1912,3021,141,0,0,3162,0
2021-01-03,FVG,312,122,190,285,26,1,0,312,0,3474,1372,2102,3306,167,1,0,3474,0
2021-01-04,FVG,1509,558,951,1391,118,0,0,1509,0,4983,1930,3053,4697,285,1,0,4983,0
2021-01-05,FVG,1678,549,1129,1348,133,197,0,1678,0,6661,2479,4182,6045,418,198,0,6661,0
2021-01-06,FVG,709,264,445,514,195,0,0,709,0,7370,2743,4627,6559,613,198,0,7370,0
2021-01-07,FVG,2089,718,1371,1758,221,110,0,2089,0,9459,3461,5998,8317,834,308,0,9459,0
2021-01-08,FVG,2319,746,1573,1668,255,396,0,2319,0,11778,4207,7571,9985,1089,704,0,11778,0
2021-01-09,FVG,2512,840,1672,1518,404,590,0,2512,0,14290,5047,9243,11503,1493,1294,0,14290,0
2021-01-10,FVG,2937,918,2019,1745,949,243,0,2937,0,17227,5965,11262,13248,2442,1537,0,17227,0
2021-01-11,FVG,1872,605,1267,1491,334,47,0,1872,0,19099,6570,12529,14739,2776,1584,0,19099,0
2021-01-12,FVG,2248,711,1537,1521,369,358,0,2248,0,21347,7281,14066,16260,3145,1942,0,21347,0
2021-01-13,FVG,2635,832,1803,1810,598,227,0,2635,0,23982,8113,15869,18070,3743,2169,0,23982,0
2021-01-14,FVG,2573,782,1791,1605,539,429,0,2573,0,26555,8895,17660,19675,4282,2598,0,26555,0
2021-01-15,FVG,2023,605,1418,1285,365,373,0,2023,0,28578,9500,19078,20960,4647,2971,0,28578,0
2021-01-16,FVG,1228,358,870,769,211,248,0,1228,0,29806,9858,19948,21729,4858,3219,0,29806,0
2021-01-17,FVG,1718,522,1196,673,559,486,0,1717,1,31524,10380,21144,22402,5417,3705,0,31523,1
2021-01-18,FVG,1951,605,1346,1354,491,106,0,1857,94,33475,10985,22490,23756,5908,3811,0,33380,95
2021-01-19,FVG,2,1,1,2,0,0,0,2,0,33477,10986,22491,23758,5908,3811,0,33382,95
2021-01-20,FVG,749,323,426,718,31,0,0,11,738,34226,11309,22917,24476,5939,3811,0,33393,833
2021-01-21,FVG,891,345,546,860,31,0,0,0,891,35117,11654,23463,25336,5970,3811,0,33393,1724
2021-01-22,FVG,92,31,61,91,1,0,0,2,90,35209,11685,23524,25427,5971,3811,0,33395,1814
2021-01-23,FVG,814,323,491,766,48,0,0,4,810,36023,12008,24015,26193,6019,3811,0,33399,2624
2021-01-24,FVG,305,119,186,277,27,1,0,1,304,36328,12127,24201,26470,6046,3812,0,33400,2928
2021-01-25,FVG,1580,566,1014,1367,141,72,0,193,1387,37908,12693,25215,27837,6187,3884,0,33593,4315
2021-01-26,FVG,1968,646,1322,1436,152,380,0,211,1757,39876,13339,26537,29273,6339,4264,0,33804,6072
2021-01-27,FVG,540,192,348,365,149,26,0,145,395,40416,13531,26885,29638,6488,4290,0,33949,6467
2020-12-27,LAZ,139,66,73,139,0,0,0,139,0,139,66,73,139,0,0,0,139,0
2020-12-28,LAZ,516,228,288,515,1,0,0,516,0,655,294,361,654,1,0,0,655,0
2020-12-29,LAZ,418,150,268,418,0,0,0,418,0,1073,444,629,1072,1,0,0,1073,0
2020-12-30,LAZ,1600,621,979,1574,0,26,0,1600,0,2673,1065,1608,2646,1,26,0,2673,0
2020-12-31,LAZ,5217,2094,3123,4926,12,279,0,5217,0,7890,3159,4731,7572,13,305,0,7890,0
2021-01-01,LAZ,3553,1381,2172,3483,2,68,0,3553,0,11443,4540,6903,11055,15,373,0,11443,0
2021-01-02,LAZ,6701,2628,4073,6239,104,358,0,6701,0,18144,7168,10976,17294,119,731,0,18144,0
2021-01-03,LAZ,5250,1972,3278,5082,103,65,0,5250,0,23394,9140,14254,22376,222,796,0,23394,0
2021-01-04,LAZ,7475,2905,4570,7072,87,316,0,7475,0,30869,12045,18824,29448,309,1112,0,30869,0
2021-01-05,LAZ,7367,2802,4565,6687,103,577,0,7367,0,38236,14847,23389,36135,412,1689,0,38236,0
2021-01-06,LAZ,5092,1949,3143,4610,162,320,0,5092,0,43328,16796,26532,40745,574,2009,0,43328,0
2021-01-07,LAZ,7708,2886,4822,6742,400,566,0,7708,0,51036,19682,31354,47487,974,2575,0,51036,0
2021-01-08,LAZ,7696,2882,4814,6327,572,797,0,7696,0,58732,22564,36168,53814,1546,3372,0,58732,0
2021-01-09,LAZ,6281,2554,3727,4917,746,618,0,6281,0,65013,25118,39895,58731,2292,3990,0,65013,0
2021-01-10,LAZ,4032,1697,2335,3127,654,251,0,4032,0,69045,26815,42230,61858,2946,4241,0,69045,0
2021-01-11,LAZ,5519,2100,3419,4446,505,568,0,5519,0,74564,28915,45649,66304,3451,4809,0,74564,0
2021-01-12,LAZ,5353,1958,3395,4102,669,582,0,5353,0,79917,30873,49044,70406,4120,5391,0,79917,0
2021-01-13,LAZ,5481,2023,3458,3820,678,980,3,5481,0,85398,32896,52502,74226,4798,6371,3,85398,0
2021-01-14,LAZ,5184,1955,3229,3568,746,786,84,5184,0,90582,34851,55731,77794,5544,7157,87,90582,0
2021-01-15,LAZ,6163,2444,3719,4124,896,988,155,6163,0,96745,37295,59450,81918,6440,8145,242,96745,0
2021-01-16,LAZ,5275,2044,3231,3148,622,1037,468,5275,0,102020,39339,62681,85066,7062,9182,710,102020,0
2021-01-17,LAZ,4412,1773,2639,2813,613,176,810,4306,106,106432,41112,65320,87879,7675,9358,1520,106326,106
2021-01-18,LAZ,5279,2032,3247,3230,884,712,453,4790,489,111711,43144,68567,91109,8559,10070,1973,111116,595
2021-01-19,LAZ,4287,1647,2640,2806,692,381,408,3834,453,115998,44791,71207,93915,9251,10451,2381,114950,1048
2021-01-20,LAZ,4292,1635,2657,3173,447,387,285,2780,1512,120290,46426,73864,97088,9698,10838,2666,117730,2560
2021-01-21,LAZ,5220,2098,3122,4700,163,232,125,196,5024,125510,48524,76986,101788,9861,11070,2791,117926,7584
2021-01-22,LAZ,3661,1442,2219,3318,151,70,122,147,3514,129171,49966,79205,105106,10012,11140,2913,118073,11098
2021-01-23,LAZ,6882,2682,4200,5819,521,417,125,255,6627,136053,52648,83405,110925,10533,11557,3038,118328,17725
2021-01-24,LAZ,5467,2109,3358,4752,455,134,126,385,5082,141520,54757,86763,115677,10988,11691,3164,118713,22807
2021-01-25,LAZ,7760,3041,4719,6791,485,362,122,420,7340,149280,57798,91482,122468,11473,12053,3286,119133,30147
2021-01-26,LAZ,7596,2905,4691,6387,453,631,125,371,7225,156876,60703,96173,128855,11926,12684,3411,119504,37372
2021-01-27,LAZ,5187,1931,3256,4042,616,415,114,474,4713,162063,62634,99429,132897,12542,13099,3525,119978,42085
2020-12-27,LIG,131,54,77,85,2,44,0,131,0,131,54,77,85,2,44,0,131,0
2020-12-28,LIG,75,26,49,72,3,0,0,75,0,206,80,126,157,5,44,0,206,0
2020-12-29,LIG,118,32,86,87,10,21,0,118,0,324,112,212,244,15,65,0,324,0
2020-12-30,LIG,9,3,6,9,0,0,0,9,0,333,115,218,253,15,65,0,333,0
2020-12-31,LIG,948,334,614,610,221,113,4,948,0,1281,449,832,863,236,178,4,1281,0
2021-01-01,LIG,144,55,89,133,11,0,0,144,0,1425,504,921,996,247,178,4,1425,0
2021-01-02,LIG,686,245,441,374,312,0,0,686,0,2111,749,1362,1370,559,178,4,2111,0
2021-01-03,LIG,724,225,499,376,348,0,0,724,0,2835,974,1861,1746,907,178,4,2835,0
2021-01-04,LIG,2301,776,1525,1525,733,43,0,2301,0,5136,1750,3386,3271,1640,221,4,5136,0
2021-01-05,LIG,2747,856,1891,1553,993,198,3,2747,0,7883,2606,5277,4824,2633,419,7,7883,0
2021-01-06,LIG,1627,599,1028,826,749,52,0,1627,0,9510,3205,6305,5650,3382,471,7,9510,0
2021-01-07,LIG,2926,1011,1915,1555,1185,186,0,2926,0,12436,4216,8220,7205,4567,657,7,12436,0
2021-01-08,LIG,2679,923,1756,1394,1087,198,0,2679,0,15115,5139,9976,8599,5654,855,7,15115,0
2021-01-09,LIG,1301,461,840,578,590,133,0,1301,0,16416,5600,10816,9177,6244,988,7,16416,0
2021-01-10,LIG,571,238,333,125,358,88,0,571,0,16987,5838,11149,9302,6602,1076,7,16987,0
2021-01-11,LIG,2412,895,1517,1304,961,147,0,2412,0,19399,6733,12666,10606,7563,1223,7,19399,0
2021-01-12,LIG,2138,795,1343,1155,766,217,0,2138,0,21537,7528,14009,11761,8329,1440,7,21537,0
2021-01-13,LIG,2621,961,1660,943,1350,328,0,2621,0,24158,8489,15669,12704,9679,1768,7,24158,0
2021-01-14,LIG,2605,924,1681,904,1406,295,0,2605,0,26763,9413,17350,13608,11085,2063,7,26763,0
2021-01-15,LIG,2064,705,1359,555,1227,282,0,2064,0,28827,10118,18709,14163,12312,2345,7,28827,0
2021-01-16,LIG,1249,541,708,188,808,253,0,1249,0,30076,10659,19417,14351,13120,2598,7,30076,0
2021-01-17,LIG,558,258,300,20,449,89,0,558,0,30634,10917,19717,14371,13569,2687,7,30634,0
2021-01-18,LIG,1624,622,1002,553,877,194,0,1475,149,32258,11539,20719,14924,14446,2881,7,32109,149
2021-01-19,LIG,1174,397,777,454,468,252,0,1089,85,33432,11936,21496,15378,14914,3133,7,33198,234
2021-01-20,LIG,1184,448,736,394,471,319,0,1173,11,34616,12384,22232,15772,15385,3452,7,34371,245
2021-01-21,LIG,816,304,512,409,222,184,1,445,371,35432,12688,22744,16181,15607,3636,8,34816,616
2021-01-22,LIG,1466,491,975,721,345,400,0,993,473,36898,13179,23719,16902,15952,4036,8,35809,1089
2021-01-23,LIG,800,290,510,622,135,43,0,145,655,37698,13469,24229,17524,16087,4079,8,35954,1744
2021-01-24,LIG,747,232,515,624,63,60,0,115,632,38445,13701,24744,18148,16150,4139,8,36069,2376
2021-01-25,LIG,2397,794,1603,1876,308,213,0,292,2105,40842,14495,26347,20024,16458,4352,8,36361,4481
2021-01-26,LIG,2248,741,1507,1804,275,169,0,13,2235,43090,15236,27854,21828,16733,4521,8,36374,6716
2021-01-27,LIG,1125,381,744,922,150,53,0,46,1079,44215,15617,28598,22750,16883,4574,8,36420,7795
2020-12-27,LOM,699,405,294,514,172,12,1,699,0,699,405,294,514,172,12,1,699,0
2020-12-28,LOM,103,44,59,99,4,0,0,103,0,802,449,353,613,176,12,1,802,0
2020-12-29,LOM,100,43,57,99,1,0,0,100,0,902,492,410,712,177,12,1,902,0
2020-12-30,LOM,113,42,71,104,9,0,0,113,0,1015,534,481,816,186,12,1,1015,0
2020-12-31,LOM,713,300,413,649,64,0,0,713,0,1728,834,894,1465,250,12,1,1728,0
2021-01-01,LOM,24,7,17,21,3,0,0,24,0,1752,841,911,1486,253,12,1,1752,0
2021-01-02,LOM,199,72,127,173,26,0,0,199,0,1951,913,1038,1659,279,12,1,1951,0
2021-01-03,LOM,850,314,536,628,217,4,1,850,0,2801,1227,1574,2287,496,16,2,2801,0
2021-01-04,LOM,5957,2048,3909,4341,1435,166,15,5957,0,8758,3275,5483,6628,1931,182,17,8758,0
2021-01-05,LOM,7657,2506,5151,5396,2088,165,8,7657,0,16415,5781,10634,12024,4019,347,25,16415,0
2021-01-06,LOM,6991,2461,4530,4432,2524,32,3,6991,0,23406,8242,15164,16456,6543,379,28,23406,0
2021-01-07,LOM,11444,3556,7888,7144,3676,559,65,11444,0,34850,11798,23052,23600,10219,938,93,34850,0
2021-01-08,LOM,12431,3849,8582,7383,4846,170,32,12431,0,47281,15647,31634,30983,15065,1108,125,47281,0
2021-01-09,LOM,11841,4345,7496,5051,6596,184,10,11841,0,59122,19992,39130,36034,21661,1292,135,59122,0
2021-01-10,LOM,10491,3949,6542,3665,6802,7,17,10491,0,69613,23941,45672,39699,28463,1299,152,69613,0
2021-01-11,LOM,15521,5203,10318,7110,7842,471,98,15521,0,85134,29144,55990,46809,36305,1770,250,85134,0
2021-01-12,LOM,19140,6395,12745,7230,10493,1260,157,19140,0,104274,35539,68735,54039,46798,3030,407,104274,0
2021-01-13,LOM,24581,7612,16969,6738,14238,3303,302,24581,0,128855,43151,85704,60777,61036,6333,709,128855,0
2021-01-14,LOM,24537,7261,17276,5790,14074,4234,439,24537,0,153392,50412,102980,66567,75110,10567,1148,153392,0
2021-01-15,LOM,22936,6786,16150,5075,13934,3523,404,22936,0,176328,57198,119130,71642,89044,14090,1552,176328,0
2021-01-16,LOM,13924,5321,8603,2542,10066,1136,180,13924,0,190252,62519,127733,74184,99110,15226,1732,190252,0
2021-01-17,LOM,7993,3244,4749,1673,6161,114,45,7797,196,198245,65763,132482,75857,105271,15340,1777,198049,196
2021-01-18,LOM,8601,2825,5776,2789,4332,1365,115,7628,973,206846,68588,138258,78646,109603,16705,1892,205677,1169
2021-01-19,LOM,7290,2167,5123,2186,3448,1544,112,6819,471,214136,70755,143381,80832,113051,18249,2004,212496,1640
2021-01-20,LOM,5023,1236,3787,1425,2463,1046,89,4909,114,219159,71991,147168,82257,115514,19295,2093,217405,1754
2021-01-21,LOM,4901,1462,3439,1665,3113,123,0,4217,684,224060,73453,150607,83922,118627,19418,2093,221622,2438
2021-01-22,LOM,2694,767,1927,941,1645,108,0,2642,52,226754,74220,152534,84863,120272,19526,2093,224264,2490
2021-01-23,LOM,994,310,684,425,552,17,0,796,198,227748,74530,153218,85288,120824,19543,2093,225060,2688
2021-01-24,LOM,1092,416,676,715,352,24,1,440,652,228840,74946,153894,86003,121176,19567,2094,225500,3340
2021-01-25,LOM,6635,2254,4381,5139,1386,104,6,442,6193,235475,77200,158275,91142,122562,19671,2100,225942,9533
2021-01-26,LOM,7862,2594,5268,6231,1547,80,4,302,7560,243337,79794,163543,97373,124109,19751,2104,226244,17093
2021-01-27,LOM,7021,2373,4648,5269,1672,78,2,482,6539,250358,82167,168191,102642,125781,19829,2106,226726,23632
2020-12-27,MAR,200,97,103,184,12,4,0,200,0,200,97,103,184,12,4,0,200,0
2020-12-30,MAR,17,5,12,14,3,0,0,17,0,217,102,115,198,15,4,0,217,0
2020-12-31,MAR,383,178,205,370,13,0,0,383,0,600,280,320,568,28,4,0,600,0
2021-01-02,MAR,453,139,314,444,9,0,0,453,0,1053,419,634,1012,37,4,0,1053,0
2021-01-03,MAR,896,348,548,759,137,0,0,896,0,1949,767,1182,1771,174,4,0,1949,0
2021-01-04,MAR,1500,563,937,1290,199,11,0,1500,0,3449,1330,2119,3061,373,15,0,3449,0
2021-01-05,MAR,1562,586,976,1436,126,0,0,1562,0,5011,1916,3095,4497,499,15,0,5011,0
2021-01-06,MAR,2181,792,1389,1738,296,147,0,2181,0,7192,2708,4484,6235,795,162,0,7192,0
2021-01-07,MAR,1802,633,1169,1480,322,0,0,1802,0,8994,3341,5653,7715,1117,162,0,8994,0
2021-01-08,MAR,1574,588,986,1226,348,0,0,1574,0,10568,3929,6639,8941,1465,162,0,10568,0
2021-01-09,MAR,1709,605,1104,1406,303,0,0,1709,0,12277,4534,7743,10347,1768,162,0,12277,0
2021-01-10,MAR,1737,699,1038,1462,275,0,0,1737,0,14014,5233,8781,11809,2043,162,0,14014,0
2021-01-11,MAR,1176,411,765,1021,155,0,0,1176,0,15190,5644,9546,12830,2198,162,0,15190,0
2021-01-12,MAR,1226,413,813,912,264,50,0,1226,0,16416,6057,10359,13742,2462,212,0,16416,0
2021-01-13,MAR,2105,746,1359,1408,621,76,0,2105,0,18521,6803,11718,15150,3083,288,0,18521,0
2021-01-14,MAR,2010,692,1318,1112,600,298,0,2010,0,20531,7495,13036,16262,3683,586,0,20531,0
2021-01-15,MAR,1771,500,1271,985,420,366,0,1771,0,22302,7995,14307,17247,4103,952,0,22302,0
2021-01-16,MAR,2006,723,1283,1059,662,285,0,2006,0,24308,8718,15590,18306,4765,1237,0,24308,0
2021-01-17,MAR,1598,682,916,964,588,46,0,1549,49,25906,9400,16506,19270,5353,1283,0,25857,49
2021-01-18,MAR,673,230,443,370,171,132,0,547,126,26579,9630,16949,19640,5524,1415,0,26404,175
2021-01-19,MAR,225,81,144,120,20,85,0,141,84,26804,9711,17093,19760,5544,1500,0,26545,259
2021-01-20,MAR,398,99,299,146,62,190,0,386,12,27202,9810,17392,19906,5606,1690,0,26931,271
2021-01-21,MAR,895,252,643,459,100,336,0,585,310,28097,10062,18035,20365,5706,2026,0,27516,581
2021-01-22,MAR,487,167,320,315,85,87,0,194,293,28584,10229,18355,20680,5791,2113,0,27710,874
2021-01-23,MAR,557,190,367,440,54,63,0,123,434,29141,10419,18722,21120,5845,2176,0,27833,1308
2021-01-24,MAR,879,338,541,762,117,0,0,17,862,30020,10757,19263,21882,5962,2176,0,27850,2170
2021-01-25,MAR,1595,558,1037,1425,114,56,0,97,1498,31615,11315,20300,23307,6076,2232,0,27947,3668
2021-01-26,MAR,1896,696,1200,1656,154,86,0,92,1804,33511,12011,21500,24963,6230,2318,0,28039,5472
2021-01-27,MAR,613,258,355,561,52,0,0,5,608,34124,12269,21855,25524,6282,2318,0,28044,6080
2020-12-27,MOL,50,20,30,29,4,17,0,50,0,50,20,30,29,4,17,0,50,0
2021-01-04,MOL,314,131,183,300,14,0,0,314,0,364,151,213,329,18,17,0,364,0
2021-01-05,MOL,449,180,269,441,8,0,0,449,0,813,331,482,770,26,17,0,813,0
2021-01-06,MOL,688,260,428,447,70,171,0,688,0,1501,591,910,1217,96,188,0,1501,0
2021-01-07,MOL,594,208,386,395,54,145,0,594,0,2095,799,1296,1612,150,333,0,2095,0
2021-01-08,MOL,426,141,285,232,74,120,0,426,0,2521,940,1581,1844,224,453,0,2521,0
2021-01-09,MOL,449,152,297,215,56,178,0,449,0,2970,1092,1878,2059,280,631,0,2970,0
2021-01-10,MOL,269,72,197,82,19,168,0,269,0,3239,1164,2075,2141,299,799,0,3239,0
2021-01-11,MOL,557,194,363,194,252,111,0,557,0,3796,1358,2438,2335,551,910,0,3796,0
2021-01-12,MOL,336,114,222,132,75,129,0,336,0,4132,1472,2660,2467,626,1039,0,4132,0
2021-01-13,MOL,472,159,313,256,74,142,0,472,0,4604,1631,2973,2723,700,1181,0,4604,0
2021-01-14,MOL,646,239,407,417,114,115,0,646,0,5250,1870,3380,3140,814,1296,0,5250,0
2021-01-15,MOL,538,242,296,398,59,81,0,538,0,5788,2112,3676,3538,873,1377,0,5788,0
2021-01-16,MOL,420,166,254,270,23,127,0,420,0,6208,2278,3930,3808,896,1504,0,6208,0
2021-01-17,MOL,78,38,40,78,0,0,0,48,30,6286,2316,3970,3886,896,1504,0,6256,30
2021-01-18,MOL,114,48,66,97,17,0,0,114,0,6400,2364,4036,3983,913,1504,0,6370,30
2021-01-19,MOL,173,63,110,90,61,22,0,162,11,6573,2427,4146,4073,974,1526,0,6532,41
2021-01-20,MOL,18,8,10,14,4,0,0,18,0,6591,2435,4156,4087,978,1526,0,6550,41
2021-01-21,MOL,6,2,4,0,6,0,0,6,0,6597,2437,4160,4087,984,1526,0,6556,41
2021-01-22,MOL,126,35,91,21,32,73,0,126,0,6723,2472,4251,4108,1016,1599,0,6682,41
2021-01-25,MOL,319,130,189,317,2,0,0,3,316,7042,2602,4440,4425,1018,1599,0,6685,357
2021-01-26,MOL,450,184,266,444,6,0,0,8,442,7492,2786,4706,4869,1024,1599,0,6693,799
2021-01-27,MOL,638,240,398,339,90,209,0,6,632,8130,3026,5104,5208,1114,1808,0,6699,1431
2020-12-27,PAB,143,65,78,56,87,0,0,143,0,143,65,78,56,87,0,0,143,0
2020-12-30,PAB,357,166,191,120,237,0,0,357,0,500,231,269,176,324,0,0,500,0
2020-12-31,PAB,850,490,360,271,579,0,0,850,0,1350,721,629,447,903,0,0,1350,0
2021-01-02,PAB,72,32,40,66,6,0,0,72,0,1422,753,669,513,909,0,0,1422,0
2021-01-04,PAB,465,189,276,280,181,4,0,465,0,1887,942,945,793,1090,4,0,1887,0
2021-01-05,PAB,820,284,536,575,245,0,0,820,0,2707,1226,1481,1368,1335,4,0,2707,0
2021-01-06,PAB,59,18,41,59,0,0,0,59,0,2766,1244,1522,1427,1335,4,0,2766,0
2021-01-07,PAB,883,308,575,339,488,0,56,883,0,3649,1552,2097,1766,1823,4,56,3649,0
2021-01-08,PAB,1468,465,1003,521,689,157,101,1468,0,5117,2017,3100,2287,2512,161,157,5117,0
2021-01-09,PAB,595,313,282,61,450,67,17,595,0,5712,2330,3382,2348,2962,228,174,5712,0
2021-01-10,PAB,2,2,0,1,1,0,0,2,0,5714,2332,3382,2349,2963,228,174,5714,0
2021-01-11,PAB,1407,434,973,218,886,119,184,1407,0,7121,2766,4355,2567,3849,347,358,7121,0
2021-01-12,PAB,1473,390,1083,200,730,469,74,1473,0,8594,3156,5438,2767,4579,816,432,8594,0
2021-01-13,PAB,1380,433,947,284,718,194,184,1380,0,9974,3589,6385,3051,5297,1010,616,9974,0
2021-01-14,PAB,1608,477,1131,260,850,277,221,1608,0,11582,4066,7516,3311,6147,1287,837,11582,0
2021-01-15,PAB,2834,1029,1805,430,820,333,1251,2834,0,14416,5095,9321,3741,6967,1620,2088,14416,0
2021-01-16,PAB,2702,1208,1494,462,331,56,1853,2702,0,17118,6303,10815,4203,7298,1676,3941,17118,0
2021-01-17,PAB,2276,1026,1250,50,268,4,1954,2264,12,19394,7329,12065,4253,7566,1680,5895,19382,12
2021-01-18,PAB,1549,578,971,256,302,7,984,1544,5,20943,7907,13036,4509,7868,1687,6879,20926,17
2021-01-19,PAB,807,348,459,150,85,0,572,677,130,21750,8255,13495,4659,7953,1687,7451,21603,147
2021-01-20,PAB,538,194,344,207,81,0,250,401,137,22288,8449,13839,4866,8034,1687,7701,22004,284
2021-01-21,PAB,808,348,460,595,118,68,27,138,670,23096,8797,14299,5461,8152,1755,7728,22142,954
2021-01-22,PAB,143,68,75,45,10,85,3,123,20,23239,8865,14374,5506,8162,1840,7731,22265,974
2021-01-23,PAB,60,25,35,60,0,0,0,0,60,23299,8890,14409,5566,8162,1840,7731,22265,1034
2021-01-25,PAB,429,166,263,348,80,0,1,3,426,23728,9056,14672,5914,8242,1840,7732,22268,1460
2021-01-26,PAB,807,291,516,662,145,0,0,1,806,24535,9347,15188,6576,8387,1840,7732,22269,2266
2021-01-27,PAB,83,27,56,53,30,0,0,1,82,24618,9374,15244,6629,8417,1840,7732,22270,2348
2020-12-27,PAT,103,40,63,76,7,20,0,103,0,103,40,63,76,7,20,0,103,0
2020-12-30,PAT,6,2,4,4,1,1,0,6,0,109,42,67,80,8,21,0,109,0
2020-12-31,PAT,1577,435,1142,808,104,665,0,1577,0,1686,477,1209,888,112,686,0,1686,0
2021-01-01,PAT,205,48,157,108,11,86,0,205,0,1891,525,1366,996,123,772,0,1891,0
2021-01-02,PAT,497,142,355,333,25,139,0,497,0,2388,667,1721,1329,148,911,0,2388,0
2021-01-03,PAT,483,158,325,409,12,62,0,483,0,2871,825,2046,1738,160,973,0,2871,0
2021-01-04,PAT,807,196,611,481,49,277,0,807,0,3678,1021,2657,2219,209,1250,0,3678,0
2021-01-05,PAT,687,228,459,478,54,155,0,687,0,4365,1249,3116,2697,263,1405,0,4365,0
2021-01-06,PAT,42,13,29,42,0,0,0,42,0,4407,1262,3145,2739,263,1405,0,4407,0
2021-01-07,PAT,1267,310,957,648,64,555,0,1267,0,5674,1572,4102,3387,327,1960,0,5674,0
2021-01-08,PAT,1437,312,1125,760,152,525,0,1437,0,7111,1884,5227,4147,479,2485,0,7111,0
2021-01-09,PAT,183,40,143,139,14,30,0,183,0,7294,1924,5370,4286,493,2515,0,7294,0
2021-01-10,PAT,84,19,65,53,19,12,0,84,0,7378,1943,5435,4339,512,2527,0,7378,0
2021-01-11,PAT,722,218,504,514,58,150,0,722,0,8100,2161,5939,4853,570,2677,0,8100,0
2021-01-12,PAT,494,158,336,397,43,54,0,494,0,8594,2319,6275,5250,613,2731,0,8594,0
2021-01-13,PAT,414,122,292,381,15,18,0,414,0,9008,2441,6567,5631,628,2749,0,9008,0
2021-01-14,PAT,690,199,491,469,19,202,0,690,0,9698,2640,7058,6100,647,2951,0,9698,0
2021-01-15,PAT,571,124,447,448,31,92,0,571,0,10269,2764,7505,6548,678,3043,0,10269,0
2021-01-16,PAT,316,147,169,299,3,14,0,316,0,10585,2911,7674,6847,681,3057,0,10585,0
2021-01-17,PAT,251,195,56,2,249,0,0,251,0,10836,3106,7730,6849,930,3057,0,10836,0
2021-01-18,PAT,629,147,482,514,42,73,0,581,48,11465,3253,8212,7363,972,3130,0,11417,48
2021-01-19,PAT,402,77,325,324,42,36,0,402,0,11867,3330,8537,7687,1014,3166,0,11819,48
2021-01-20,PAT,287,71,216,224,15,48,0,275,12,12154,3401,8753,7911,1029,3214,0,12094,60
2021-01-21,PAT,349,93,256,289,44,16,0,227,122,12503,3494,9009,8200,1073,3230,0,12321,182
2021-01-22,PAT,1608,418,1190,863,126,619,0,313,1295,14111,3912,10199,9063,1199,3849,0,12634,1477
2021-01-23,PAT,571,331,240,219,264,88,0,384,187,14682,4243,10439,9282,1463,3937,0,13018,1664
2021-01-24,PAT,545,274,271,310,235,0,0,222,323,15227,4517,10710,9592,1698,3937,0,13240,1987
2021-01-25,PAT,766,204,562,481,30,255,0,23,743,15993,4721,11272,10073,1728,4192,0,13263,2730
2021-01-26,PAT,498,138,360,398,16,84,0,26,472,16491,4859,11632,10471,1744,4276,0,13289,3202
2021-01-27,PAT,220,80,140,207,1,12,0,56,164,16711,4939,11772,10678,1745,4288,0,13345,3366
2020-12-27,PIE,912,368,544,760,76,76,0,912,0,912,368,544,760,76,76,0,912,0
2020-12-30,PIE,730,322,408,685,45,0,0,730,0,1642,690,952,1445,121,76,0,1642,0
2020-12-31,PIE,3878,1318,2560,3386,359,133,0,3878,0,5520,2008,3512,4831,480,209,0,5520,0
2021-01-01,PIE,1038,395,643,922,116,0,0,1038,0,6558,2403,4155,5753,596,209,0,6558,0
2021-01-02,PIE,3538,1134,2404,3072,413,53,0,3538,0,10096,3537,6559,8825,1009,262,0,10096,0
2021-01-03,PIE,3060,966,2094,2713,295,52,0,3060,0,13156,4503,8653,11538,1304,314,0,13156,0
2021-01-04,PIE,5556,1675,3881,4584,737,235,0,5556,0,18712,6178,12534,16122,2041,549,0,18712,0
2021-01-05,PIE,5374,1603,3771,4362,730,282,0,5374,0,24086,7781,16305,20484,2771,831,0,24086,0
2021-01-06,PIE,3114,1110,2004,2367,434,313,0,3114,0,27200,8891,18309,22851,3205,1144,0,27200,0
2021-01-07,PIE,5326,1718,3608,4128,877,321,0,5326,0,32526,10609,21917,26979,4082,1465,0,32526,0
2021-01-08,PIE,5504,1751,3753,4068,1027,409,0,5504,0,38030,12360,25670,31047,5109,1874,0,38030,0
2021-01-09,PIE,6199,2187,4012,4489,1127,583,0,6199,0,44229,14547,29682,35536,6236,2457,0,44229,0
2021-01-10,PIE,5195,2272,2923,3896,784,515,0,5195,0,49424,16819,32605,39432,7020,2972,0,49424,0
2021-01-11,PIE,8737,2978,5759,6054,1554,1129,0,8737,0,58161,19797,38364,45486,8574,4101,0,58161,0
2021-01-12,PIE,9969,3381,6588,6809,1990,1170,0,9969,0,68130,23178,44952,52295,10564,5271,0,68130,0
2021-01-13,PIE,10017,3209,6808,6447,2249,1321,0,10017,0,78147,26387,51760,58742,12813,6592,0,78147,0
2021-01-14,PIE,9737,3144,6593,6137,2120,1480,0,9737,0,87884,29531,58353,64879,14933,8072,0,87884,0
2021-01-15,PIE,8944,2945,5999,5486,1920,1538,0,8944,0,96828,32476,64352,70365,16853,9610,0,96828,0
2021-01-16,PIE,7739,2628,5111,4786,1588,1365,0,7739,0,104567,35104,69463,75151,18441,10975,0,104567,0
2021-01-17,PIE,3511,1167,2344,2079,593,839,0,2864,647,108078,36271,71807,77230,19034,11814,0,107431,647
2021-01-18,PIE,6083,2034,4049,3214,1401,1468,0,5836,247,114161,38305,75856,80444,20435,13282,0,113267,894
2021-01-19,PIE,6387,2097,4290,3635,1312,1440,0,6285,102,120548,40402,80146,84079,21747,14722,0,119552,996
2021-01-20,PIE,6345,2027,4318,3551,1149,1645,0,5619,726,126893,42429,84464,87630,22896,16367,0,125171,1722
2021-01-21,PIE,6671,2247,4424,4673,852,1146,0,3185,3486,133564,44676,88888,92303,23748,17513,0,128356,5208
2021-01-22,PIE,3772,1226,2546,2245,648,879,0,2432,1340,137336,45902,91434,94548,24396,18392,0,130788,6548
2021-01-23,PIE,4188,1311,2877,3166,522,500,0,877,3311,141524,47213,94311,97714,24918,18892,0,131665,9859
2021-01-24,PIE,3148,956,2192,2630,372,146,0,432,2716,144672,48169,96503,100344,25290,19038,0,132097,12575
2021-01-25,PIE,6165,1928,4237,4774,863,528,0,974,5191,150837,50097,100740,105118,26153,19566,0,133071,17766
2021-01-26,PIE,6244,1848,4396,4696,860,688,0,713,5531,157081,51945,105136,109814,27013,20254,0,133784,23297
2021-01-27,PIE,3910,1362,2548,2752,607,551,0,878,3032,160991,53307,107684,112566,27620,20805,0,134662,26329
2020-12-27,PUG,506,249,257,400,43,63,0,506,0,506,249,257,400,43,63,0,506,0
2020-12-30,PUG,2,0,2,1,1,0,0,2,0,508,249,259,401,44,63,0,508,0
2020-12-31,PUG,1631,782,849,1419,168,44,0,1631,0,2139,1031,1108,1820,212,107,0,2139,0
2021-01-01,PUG,146,60,86,139,7,0,0,146,0,2285,1091,1194,1959,219,107,0,2285,0
2021-01-02,PUG,2927,1285,1642,2654,252,21,0,2927,0,5212,2376,2836,4613,471,128,0,5212,0
2021-01-03,PUG,2004,942,1062,1673,188,143,0,2004,0,7216,3318,3898,6286,659,271,0,7216,0
2021-01-04,PUG,4496,2009,2487,4237,248,11,0,4496,0,11712,5327,6385,10523,907,282,0,11712,0
2021-01-05,PUG,5088,2238,2850,4438,550,95,5,5088,0,16800,7565,9235,14961,1457,377,5,16800,0
2021-01-06,PUG,3907,1645,2262,2955,576,376,0,3907,0,20707,9210,11497,17916,2033,753,5,20707,0
2021-01-07,PUG,5670,2429,3241,4944,506,220,0,5670,0,26377,11639,14738,22860,2539,973,5,26377,0
2021-01-08,PUG,5319,2239,3080,4308,721,290,0,5319,0,31696,13878,17818,27168,3260,1263,5,31696,0
2021-01-09,PUG,4796,2214,2582,4125,428,239,4,4796,0,36492,16092,20400,31293,3688,1502,9,36492,0
2021-01-10,PUG,2331,1051,1280,1846,315,170,0,2331,0,38823,17143,21680,33139,4003,1672,9,38823,0
2021-01-11,PUG,3725,1577,2148,3020,534,171,0,3725,0,42548,18720,23828,36159,4537,1843,9,42548,0
2021-01-12,PUG,4133,1733,2400,3345,583,204,1,4133,0,46681,20453,26228,39504,5120,2047,10,46681,0
2021-01-13,PUG,4478,1698,2780,3753,497,228,0,4478,0,51159,22151,29008,43257,5617,2275,10,51159,0
2021-01-14,PUG,3986,1547,2439,2956,536,494,0,3986,0,55145,23698,31447,46213,6153,2769,10,55145,0
2021-01-15,PUG,4433,1808,2625,3449,479,505,0,4433,0,59578,25506,34072,49662,6632,3274,10,59578,0
2021-01-16,PUG,2441,1006,1435,1579,352,510,0,2441,0,62019,26512,35507,51241,6984,3784,10,62019,0
2021-01-17,PUG,1285,581,704,808,153,324,0,1216,69,63304,27093,36211,52049,7137,4108,10,63235,69
2021-01-18,PUG,1827,756,1071,1116,266,445,0,1478,349,65131,27849,37282,53165,7403,4553,10,64713,418
2021-01-19,PUG,1212,446,766,516,128,568,0,1208,4,66343,28295,38048,53681,7531,5121,10,65921,422
2021-01-20,PUG,1533,535,998,774,174,585,0,1525,8,67876,28830,39046,54455,7705,5706,10,67446,430
2021-01-21,PUG,2113,893,1220,1391,199,523,0,1266,847,69989,29723,40266,55846,7904,6229,10,68712,1277
2021-01-22,PUG,1407,576,831,872,162,373,0,992,415,71396,30299,41097,56718,8066,6602,10,69704,1692
2021-01-23,PUG,3021,1283,1738,2483,265,273,0,877,2144,74417,31582,42835,59201,8331,6875,10,70581,3836
2021-01-24,PUG,1659,744,915,1264,247,148,0,146,1513,76076,32326,43750,60465,8578,7023,10,70727,5349
2021-01-25,PUG,3663,1619,2044,3315,180,168,0,421,3242,79739,33945,45794,63780,8758,7191,10,71148,8591
2021-01-26,PUG,5139,2280,2859,4670,241,228,0,563,4576,84878,36225,48653,68450,8999,7419,10,71711,13167
2021-01-27,PUG,3205,1371,1834,2804,239,162,0,376,2829,88083,37596,50487,71254,9238,7581,10,72087,15996
2020-12-27,SAR,65,34,31,65,0,0,0,65,0,65,34,31,65,0,0,0,65,0
2020-12-28,SAR,65,25,40,65,0,0,0,65,0,130,59,71,130,0,0,0,130,0
2020-12-29,SAR,56,31,25,55,1,0,0,56,0,186,90,96,185,1,0,0,186,0
2020-12-31,SAR,32,16,16,28,4,0,0,32,0,218,106,112,213,5,0,0,218,0
2021-01-01,SAR,30,16,14,30,0,0,0,30,0,248,122,126,243,5,0,0,248,0
2021-01-02,SAR,60,21,39,60,0,0,0,60,0,308,143,165,303,5,0,0,308,0
2021-01-03,SAR,90,36,54,89,1,0,0,90,0,398,179,219,392,6,0,0,398,0
2021-01-04,SAR,590,217,373,563,27,0,0,590,0,988,396,592,955,33,0,0,988,0
2021-01-05,SAR,1327,446,881,1281,46,0,0,1327,0,2315,842,1473,2236,79,0,0,2315,0
2021-01-06,SAR,1598,544,1054,1480,118,0,0,1598,0,3913,1386,2527,3716,197,0,0,3913,0
2021-01-07,SAR,3096,1072,2024,2704,392,0,0,3096,0,7009,2458,4551,6420,589,0,0,7009,0
2021-01-08,SAR,3249,1180,2069,2856,393,0,0,3249,0,10258,3638,6620,9276,982,0,0,10258,0
2021-01-09,SAR,4016,1414,2602,3177,839,0,0,4016,0,14274,5052,9222,12453,1821,0,0,14274,0
2021-01-10,SAR,2177,747,1430,1693,484,0,0,2177,0,16451,5799,10652,14146,2305,0,0,16451,0
2021-01-11,SAR,1180,504,676,688,492,0,0,1180,0,17631,6303,11328,14834,2797,0,0,17631,0
2021-01-12,SAR,865,408,457,514,351,0,0,865,0,18496,6711,11785,15348,3148,0,0,18496,0
2021-01-13,SAR,572,178,394,437,135,0,0,572,0,19068,6889,12179,15785,3283,0,0,19068,0
2021-01-14,SAR,1104,426,678,880,224,0,0,1104,0,20172,7315,12857,16665,3507,0,0,20172,0
2021-01-15,SAR,1558,570,988,1164,394,0,0,1558,0,21730,7885,13845,17829,3901,0,0,21730,0
2021-01-16,SAR,1491,525,966,1267,224,0,0,1491,0,23221,8410,14811,19096,4125,0,0,23221,0
2021-01-17,SAR,859,277,582,741,118,0,0,858,1,24080,8687,15393,19837,4243,0,0,24079,1
2021-01-18,SAR,900,326,574,713,187,0,0,776,124,24980,9013,15967,20550,4430,0,0,24855,125
2021-01-19,SAR,747,270,477,423,165,159,0,692,55,25727,9283,16444,20973,4595,159,0,25547,180
2021-01-20,SAR,209,77,132,134,75,0,0,207,2,25936,9360,16576,21107,4670,159,0,25754,182
2021-01-21,SAR,126,60,66,60,66,0,0,94,32,26062,9420,16642,21167,4736,159,0,25848,214
2021-01-22,SAR,82,46,36,44,38,0,0,54,28,26144,9466,16678,21211,4774,159,0,25902,242
2021-01-23,SAR,60,22,38,60,0,0,0,0,60,26204,9488,16716,21271,4774,159,0,25902,302
2021-01-24,SAR,90,34,56,89,1,0,0,5,85,26294,9522,16772,21360,4775,159,0,25907,387
2021-01-25,SAR,587,212,375,552,35,0,0,22,565,26881,9734,17147,21912,4810,159,0,25929,952
2021-01-26,SAR,1335,453,882,1291,44,0,0,27,1308,28216,10187,18029,23203,4854,159,0,25956,2260
2021-01-27,SAR,1294,461,833,1181,113,0,0,78,1216,29510,10648,18862,24384,4967,159,0,26034,3476
2020-12-27,SIC,71,45,26,55,1,15,0,71,0,71,45,26,55,1,15,0,71,0
2020-12-28,SIC,186,110,76,184,2,0,0,186,0,257,155,102,239,3,15,0,257,0
2020-12-29,SIC,210,131,79,210,0,0,0,210,0,467,286,181,449,3,15,0,467,0
2020-12-30,SIC,101,59,42,91,10,0,0,101,0,568,345,223,540,13,15,0,568,0
2020-12-31,SIC,794,431,363,745,49,0,0,794,0,1362,776,586,1285,62,15,0,1362,0
2021-01-01,SIC,670,359,311,601,69,0,0,670,0,2032,1135,897,1886,131,15,0,2032,0
2021-01-02,SIC,4154,2160,1994,3668,486,0,0,4154,0,6186,3295,2891,5554,617,15,0,6186,0
2021-01-03,SIC,4324,2251,2073,4012,312,0,0,4324,0,10510,5546,4964,9566,929,15,0,10510,0
2021-01-04,SIC,7421,3692,3729,6744,671,6,0,7421,0,17931,9238,8693,16310,1600,21,0,17931,0
2021-01-05,SIC,9815,4828,4987,8462,1165,188,0,9815,0,27746,14066,13680,24772,2765,209,0,27746,0
2021-01-06,SIC,5993,3168,2825,5283,708,2,0,5993,0,33739,17234,16505,30055,3473,211,0,33739,0
2021-01-07,SIC,8505,3903,4602,7102,1197,206,0,8505,0,42244,21137,21107,37157,4670,417,0,42244,0
2021-01-08,SIC,7753,3569,4184,6110,1432,211,0,7753,0,49997,24706,25291,43267,6102,628,0,49997,0
2021-01-09,SIC,6882,3189,3693,4682,1769,431,0,6882,0,56879,27895,28984,47949,7871,1059,0,56879,0
2021-01-10,SIC,3481,1556,1925,2019,1005,457,0,3481,0,60360,29451,30909,49968,8876,1516,0,60360,0
2021-01-11,SIC,5545,2437,3108,3658,1551,336,0,5545,0,65905,31888,34017,53626,10427,1852,0,65905,0
2021-01-12,SIC,4006,1934,2072,2599,1216,191,0,4006,0,69911,33822,36089,56225,11643,2043,0,69911,0
2021-01-13,SIC,4838,2257,2581,2804,1610,424,0,4838,0,74749,36079,38670,59029,13253,2467,0,74749,0
2021-01-14,SIC,4958,2354,2604,2874,1832,252,0,4958,0,79707,38433,41274,61903,15085,2719,0,79707,0
2021-01-15,SIC,4808,2112,2696,2658,1697,453,0,4808,0,84515,40545,43970,64561,16782,3172,0,84515,0
2021-01-16,SIC,2581,1104,1477,1189,1101,291,0,2581,0,87096,41649,45447,65750,17883,3463,0,87096,0
2021-01-17,SIC,1203,542,661,569,484,150,0,1159,44,88299,42191,46108,66319,18367,3613,0,88255,44
2021-01-18,SIC,1431,591,840,650,589,192,0,1338,93,89730,42782,46948,66969,18956,3805,0,89593,137
2021-01-19,SIC,940,412,528,371,423,146,0,769,171,90670,43194,47476,67340,19379,3951,0,90362,308
2021-01-20,SIC,779,395,384,403,187,189,0,556,223,91449,43589,47860,67743,19566,4140,0,90918,531
2021-01-21,SIC,1273,626,647,960,185,128,0,479,794,92722,44215,48507,68703,19751,4268,0,91397,1325
2021-01-22,SIC,1198,605,593,1000,82,116,0,239,959,93920,44820,49100,69703,19833,4384,0,91636,2284
2021-01-23,SIC,4001,2072,1929,3768,217,16,0,224,3777,97921,46892,51029,73471,20050,4400,0,91860,6061
2021-01-24,SIC,4264,2228,2036,3921,340,3,0,147,4117,102185,49120,53065,77392,20390,4403,0,92007,10178
2021-01-25,SIC,6768,3318,3450,5971,727,70,0,292,6476,108953,52438,56515,83363,21117,4473,0,92299,16654
2021-01-26,SIC,9043,4454,4589,7969,840,234,0,225,8818,117996,56892,61104,91332,21957,4707,0,92524,25472
2021-01-27,SIC,2907,1511,1396,2453,444,10,0,31,2876,120903,58403,62500,93785,22401,4717,0,92555,28348
2020-12-27,TOS,619,267,352,460,146,13,0,619,0,619,267,352,460,146,13,0,619,0
2020-12-30,TOS,325,104,221,34,10,281,0,325,0,944,371,573,494,156,294,0,944,0
2020-12-31,TOS,786,196,590,97,7,682,0,786,0,1730,567,1163,591,163,976,0,1730,0
2021-01-01,TOS,2366,786,1580,1716,2,648,0,2366,0,4096,1353,2743,2307,165,1624,0,4096,0
2021-01-02,TOS,3497,1097,2400,2682,15,800,0,3497,0,7593,2450,5143,4989,180,2424,0,7593,0
2021-01-03,TOS,3335,1052,2283,2564,9,762,0,3335,0,10928,3502,7426,7553,189,3186,0,10928,0
2021-01-04,TOS,5061,1892,3169,4099,32,930,0,5061,0,15989,5394,10595,11652,221,4116,0,15989,0
2021-01-05,TOS,5244,1755,3489,4354,11,879,0,5244,0,21233,7149,14084,16006,232,4995,0,21233,0
2021-01-06,TOS,4512,1458,3054,3978,10,524,0,4512,0,25745,8607,17138,19984,242,5519,0,25745,0
2021-01-07,TOS,5987,1742,4245,5300,30,657,0,5987,0,31732,10349,21383,25284,272,6176,0,31732,0
2021-01-08,TOS,5942,1640,4302,5358,39,545,0,5942,0,37674,11989,25685,30642,311,6721,0,37674,0
2021-01-09,TOS,4480,1594,2886,3778,144,558,0,4480,0,42154,13583,28571,34420,455,7279,0,42154,0
2021-01-10,TOS,2995,1100,1895,2432,138,425,0,2995,0,45149,14683,30466,36852,593,7704,0,45149,0
2021-01-11,TOS,5087,1687,3400,4356,210,521,0,5087,0,50236,16370,33866,41208,803,8225,0,50236,0
2021-01-12,TOS,3580,1396,2184,2943,283,354,0,3580,0,53816,17766,36050,44151,1086,8579,0,53816,0
2021-01-13,TOS,4060,1398,2662,3307,349,404,0,4060,0,57876,19164,38712,47458,1435,8983,0,57876,0
2021-01-14,TOS,3253,1179,2074,2458,475,320,0,3253,0,61129,20343,40786,49916,1910,9303,0,61129,0
2021-01-15,TOS,3878,1347,2531,2758,676,444,0,3878,0,65007,21690,43317,52674,2586,9747,0,65007,0
2021-01-16,TOS,3247,1037,2210,2493,537,217,0,3247,0,68254,22727,45527,55167,3123,9964,0,68254,0
2021-01-17,TOS,2486,837,1649,2004,293,189,0,1973,513,70740,23564,47176,57171,3416,10153,0,70227,513
2021-01-18,TOS,1119,636,483,430,314,375,0,1021,98,71859,24200,47659,57601,3730,10528,0,71248,611
2021-01-19,TOS,1102,529,573,392,221,489,0,1102,0,72961,24729,48232,57993,3951,11017,0,72350,611
2021-01-20,TOS,1331,637,694,434,256,641,0,1083,248,74292,25366,48926,58427,4207,11658,0,73433,859
2021-01-21,TOS,1569,686,883,573,220,776,0,850,719,75861,26052,49809,59000,4427,12434,0,74283,1578
2021-01-22,TOS,2864,1063,1801,2027,81,756,0,525,2339,78725,27115,51610,61027,4508,13190,0,74808,3917
2021-01-23,TOS,3965,1360,2605,2952,172,841,0,639,3326,82690,28475,54215,63979,4680,14031,0,75447,7243
2021-01-24,TOS,3347,1072,2275,2601,37,709,0,199,3148,86037,29547,56490,66580,4717,14740,0,75646,10391
2021-01-25,TOS,5117,1895,3222,4153,56,908,0,247,4870,91154,31442,59712,70733,4773,15648,0,75893,15261
2021-01-26,TOS,5339,1774,3565,4341,83,915,0,195,5144,96493,33216,63277,75074,4856,16563,0,76088,20405
2021-01-27,TOS,4164,1350,2814,3505,62,597,0,168,3996,100657,34566,66091,78579,4918,17160,0,76256,24401
2020-12-27,UMB,85,45,40,67,2,16,0,85,0,85,45,40,67,2,16,0,85,0
2020-12-31,UMB,322,127,195,310,12,0,0,322,0,407,172,235,377,14,16,0,407,0
2021-01-01,UMB,269,102,167,268,1,0,0,269,0,676,274,402,645,15,16,0,676,0
2021-01-02,UMB,301,110,191,301,0,0,0,301,0,977,384,593,946,15,16,0,977,0
2021-01-03,UMB,267,111,156,267,0,0,0,267,0,1244,495,749,1213,15,16,0,1244,0
2021-01-04,UMB,809,397,412,808,1,0,0,809,0,2053,892,1161,2021,16,16,0,2053,0
2021-01-05,UMB,850,428,422,845,5,0,0,850,0,2903,1320,1583,2866,21,16,0,2903,0
2021-01-06,UMB,843,323,520,840,3,0,0,843,0,3746,1643,2103,3706,24,16,0,3746,0
2021-01-07,UMB,1269,378,891,881,4,384,0,1269,0,5015,2021,2994,4587,28,400,0,5015,0
2021-01-08,UMB,1189,342,847,926,9,254,0,1189,0,6204,2363,3841,5513,37,654,0,6204,0
2021-01-09,UMB,1694,487,1207,884,12,798,0,1694,0,7898,2850,5048,6397,49,1452,0,7898,0
2021-01-10,UMB,1038,267,771,737,9,292,0,1038,0,8936,3117,5819,7134,58,1744,0,8936,0
2021-01-11,UMB,1268,333,935,876,20,372,0,1268,0,10204,3450,6754,8010,78,2116,0,10204,0
2021-01-12,UMB,784,247,537,665,14,105,0,784,0,10988,3697,7291,8675,92,2221,0,10988,0
2021-01-13,UMB,450,139,311,379,29,42,0,450,0,11438,3836,7602,9054,121,2263,0,11438,0
2021-01-14,UMB,772,205,567,699,36,37,0,772,0,12210,4041,8169,9753,157,2300,0,12210,0
2021-01-15,UMB,692,212,480,588,44,60,0,692,0,12902,4253,8649,10341,201,2360,0,12902,0
2021-01-16,UMB,220,72,148,145,32,43,0,220,0,13122,4325,8797,10486,233,2403,0,13122,0
2021-01-17,UMB,54,17,37,47,7,0,0,54,0,13176,4342,8834,10533,240,2403,0,13176,0
2021-01-18,UMB,588,215,373,314,150,124,0,504,84,13764,4557,9207,10847,390,2527,0,13680,84
2021-01-19,UMB,103,23,80,21,2,80,0,103,0,13867,4580,9287,10868,392,2607,0,13783,84
2021-01-20,UMB,612,222,390,582,16,14,0,612,0,14479,4802,9677,11450,408,2621,0,14395,84
2021-01-21,UMB,607,200,407,426,13,168,0,338,269,15086,5002,10084,11876,421,2789,0,14733,353
2021-01-22,UMB,276,105,171,273,1,2,0,32,244,15362,5107,10255,12149,422,2791,0,14765,597
2021-01-23,UMB,277,100,177,276,1,0,0,2,275,15639,5207,10432,12425,423,2791,0,14767,872
2021-01-24,UMB,254,104,150,254,0,0,0,1,253,15893,5311,10582,12679,423,2791,0,14768,1125
2021-01-25,UMB,647,322,325,645,2,0,0,5,642,16540,5633,10907,13324,425,2791,0,14773,1767
2021-01-26,UMB,814,390,424,813,1,0,0,18,796,17354,6023,11331,14137,426,2791,0,14791,2563
2021-01-27,UMB,690,286,404,689,1,0,0,5,685,18044,6309,11735,14826,427,2791,0,14796,3248
2020-12-27,VDA,20,9,11,20,0,0,0,20,0,20,9,11,20,0,0,0,20,0
2020-12-31,VDA,18,4,14,16,2,0,0,18,0,38,13,25,36,2,0,0,38,0
2021-01-02,VDA,6,5,1,0,0,6,0,6,0,44,18,26,36,2,6,0,44,0
2021-01-04,VDA,142,59,83,126,16,0,0,142,0,186,77,109,162,18,6,0,186,0
2021-01-05,VDA,150,54,96,127,12,11,0,150,0,336,131,205,289,30,17,0,336,0
2021-01-06,VDA,65,33,32,28,19,18,0,65,0,401,164,237,317,49,35,0,401,0
2021-01-07,VDA,275,111,164,194,76,5,0,275,0,676,275,401,511,125,40,0,676,0
2021-01-08,VDA,298,130,168,171,111,16,0,298,0,974,405,569,682,236,56,0,974,0
2021-01-09,VDA,443,199,244,153,268,22,0,443,0,1417,604,813,835,504,78,0,1417,0
2021-01-10,VDA,220,71,149,168,33,19,0,220,0,1637,675,962,1003,537,97,0,1637,0
2021-01-11,VDA,325,112,213,206,89,30,0,325,0,1962,787,1175,1209,626,127,0,1962,0
2021-01-12,VDA,300,71,229,240,49,11,0,300,0,2262,858,1404,1449,675,138,0,2262,0
2021-01-13,VDA,282,94,188,134,148,0,0,282,0,2544,952,1592,1583,823,138,0,2544,0
2021-01-14,VDA,237,69,168,151,84,0,2,237,0,2781,1021,1760,1734,907,138,2,2781,0
2021-01-15,VDA,218,82,136,115,69,28,6,218,0,2999,1103,1896,1849,976,166,8,2999,0
2021-01-16,VDA,236,80,156,127,36,22,51,236,0,3235,1183,2052,1976,1012,188,59,3235,0
2021-01-17,VDA,131,56,75,49,3,20,59,131,0,3366,1239,2127,2025,1015,208,118,3366,0
2021-01-18,VDA,213,74,139,29,111,27,46,213,0,3579,1313,2266,2054,1126,235,164,3579,0
2021-01-19,VDA,256,77,179,160,24,15,57,256,0,3835,1390,2445,2214,1150,250,221,3835,0
2021-01-20,VDA,23,8,15,0,0,6,17,23,0,3858,1398,2460,2214,1150,256,238,3858,0
2021-01-21,VDA,33,12,21,0,0,33,0,33,0,3891,1410,2481,2214,1150,289,238,3891,0
2021-01-22,VDA,56,21,35,36,0,20,0,20,36,3947,1431,2516,2250,1150,309,238,3911,36
2021-01-25,VDA,147,65,82,125,16,6,0,0,147,4094,1496,2598,2375,1166,315,238,3911,183
2021-01-26,VDA,139,48,91,115,12,12,0,0,139,4233,1544,2689,2490,1178,327,238,3911,322
2021-01-27,VDA,76,34,42,17,24,18,17,27,49,4309,1578,2731,2507,1202,345,255,3938,371
2020-12-27,VEN,880,395,485,875,5,0,0,880,0,880,395,485,875,5,0,0,880,0
2020-12-30,VEN,699,245,454,598,62,39,0,699,0,1579,640,939,1473,67,39,0,1579,0
2020-12-31,VEN,3222,1045,2177,2698,273,251,0,3222,0,4801,1685,3116,4171,340,290,0,4801,0
2021-01-01,VEN,1524,470,1054,1485,38,1,0,1524,0,6325,2155,4170,5656,378,291,0,6325,0
2021-01-02,VEN,5742,1767,3975,4774,422,544,2,5742,0,12067,3922,8145,10430,800,835,2,12067,0
2021-01-03,VEN,5156,1562,3594,4457,450,249,0,5156,0,17223,5484,11739,14887,1250,1084,2,17223,0
2021-01-04,VEN,6723,2029,4694,5197,611,914,1,6723,0,23946,7513,16433,20084,1861,1998,3,23946,0
2021-01-05,VEN,7331,2182,5149,5403,807,1121,0,7331,0,31277,9695,21582,25487,2668,3119,3,31277,0
2021-01-06,VEN,8074,2362,5712,6208,1074,791,1,8074,0,39351,12057,27294,31695,3742,3910,4,39351,0
2021-01-07,VEN,8325,2309,6016,5422,1101,1802,0,8325,0,47676,14366,33310,37117,4843,5712,4,47676,0
2021-01-08,VEN,9340,2808,6532,5877,1660,1800,3,9340,0,57016,17174,39842,42994,6503,7512,7,57016,0
2021-01-09,VEN,7884,2517,5367,4917,1415,1550,2,7884,0,64900,19691,45209,47911,7918,9062,9,64900,0
2021-01-10,VEN,5012,1659,3353,3196,1355,459,2,5012,0,69912,21350,48562,51107,9273,9521,11,69912,0
2021-01-11,VEN,7170,2083,5087,3406,1595,1922,247,7170,0,77082,23433,53649,54513,10868,11443,258,77082,0
2021-01-12,VEN,5189,1509,3680,2200,1096,1727,166,5189,0,82271,24942,57329,56713,11964,13170,424,82271,0
2021-01-13,VEN,5898,1581,4317,2711,1358,1826,3,5898,0,88169,26523,61646,59424,13322,14996,427,88169,0
2021-01-14,VEN,6973,1884,5089,2908,1648,2400,17,6973,0,95142,28407,66735,62332,14970,17396,444,95142,0
2021-01-15,VEN,5716,1757,3959,2595,1678,1434,9,5716,0,100858,30164,70694,64927,16648,18830,453,100858,0
2021-01-16,VEN,4487,1508,2979,2571,1275,641,0,4487,0,105345,31672,73673,67498,17923,19471,453,105345,0
2021-01-17,VEN,1928,779,1149,1146,659,120,3,1578,350,107273,32451,74822,68644,18582,19591,456,106923,350
2021-01-18,VEN,2684,760,1924,1066,677,933,8,2480,204,109957,33211,76746,69710,19259,20524,464,109403,554
2021-01-19,VEN,1303,470,833,706,274,317,6,1154,149,111260,33681,77579,70416,19533,20841,470,110557,703
2021-01-20,VEN,1040,368,672,687,140,213,0,388,652,112300,34049,78251,71103,19673,21054,470,110945,1355
2021-01-21,VEN,2254,718,1536,1970,165,119,0,20,2234,114554,34767,79787,73073,19838,21173,470,110965,3589
2021-01-22,VEN,1081,332,749,939,84,58,0,27,1054,115635,35099,80536,74012,19922,21231,470,110992,4643
2021-01-23,VEN,4062,1254,2808,3393,218,450,1,35,4027,119697,36353,83344,77405,20140,21681,471,111027,8670
2021-01-24,VEN,4114,1217,2897,3732,160,222,0,28,4086,123811,37570,86241,81137,20300,21903,471,111055,12756
2021-01-25,VEN,6364,2037,4327,4958,551,848,7,170,6194,130175,39607,90568,86095,20851,22751,478,111225,18950
2021-01-26,VEN,6749,2019,4730,5182,688,879,0,156,6593,136924,41626,95298,91277,21539,23630,478,111381,25543
2021-01-27,VEN,6420,1851,4569,4559,1110,751,0,188,6232,143344,43477,99867,95836,22649,24381,478,111569,31775
