data_somministrazione,area,nuovi_vaccinati,sesso_maschile,sesso_femminile,operatori_sanitari,personale_non_sanitario,ospiti_rsa,vaccinati_totale,sesso_maschile_totale,sesso_femminile_totale,operatori_sanitari_totale,personale_non_sanitario_totale,ospiti_rsa_totale
2020-12-27,ABR,135,71,64,115,18,2,135,71,64,115,18,2
2021-01-02,ABR,550,218,332,545,5,0,685,289,396,660,23,2
2021-01-03,ABR,564,219,345,556,8,0,1249,508,741,1216,31,2
2021-01-04,ABR,1411,578,833,1406,5,0,2660,1086,1574,2622,36,2
2021-01-05,ABR,1617,604,1013,1607,10,0,4277,1690,2587,4229,46,2
2021-01-06,ABR,1720,646,1074,1554,33,133,5997,2336,3661,5783,79,135
2021-01-07,ABR,1716,572,1144,1679,37,0,7713,2908,4805,7462,116,135
2021-01-08,ABR,1638,539,1099,1596,42,0,9351,3447,5904,9058,158,135
2021-01-09,ABR,1483,565,918,1428,55,0,10834,4012,6822,10486,213,135
2021-01-10,ABR,1123,403,720,1083,40,0,11957,4415,7542,11569,253,135
2021-01-11,ABR,1507,539,968,1351,124,32,13464,4954,8510,12920,377,167
2021-01-12,ABR,1964,644,1320,1627,242,95,15428,5598,9830,14547,619,262
2020-12-27,BAS,208,83,125,208,0,0,208,83,125,208,0,0
2021-01-02,BAS,885,356,529,837,48,0,1093,439,654,1045,48,0
2021-01-03,BAS,723,288,435,717,6,0,1816,727,1089,1762,54,0
2021-01-04,BAS,407,190,217,352,55,0,2223,917,1306,2114,109,0
2021-01-05,BAS,648,262,386,619,29,0,2871,1179,1692,2733,138,0
2021-01-06,BAS,220,104,116,220,0,0,3091,1283,1808,2953,138,0
2021-01-07,BAS,647,325,322,612,8,27,3738,1608,2130,3565,146,27
2021-01-08,BAS,337,143,194,275,23,39,4075,1751,2324,3840,169,66
2021-01-09,BAS,462,164,298,367,26,69,4537,1915,2622,4207,195,135
2021-01-11,BAS,160,49,111,94,6,60,4697,1964,2733,4301,201,195
2021-01-12,BAS,90,21,69,62,6,22,4787,1985,2802,4363,207,217
2020-12-27,CAL,274,147,127,272,2,0,274,147,127,272,2,0
2020-12-28,CAL,5,2,3,5,0,0,279,149,130,277,2,0
2021-01-02,CAL,169,97,72,169,0,0,448,246,202,446,2,0
2021-01-03,CAL,5,3,2,4,1,0,453,249,204,450,3,0
2021-01-04,CAL,1088,536,552,1038,50,0,1541,785,756,1488,53,0
2021-01-05,CAL,1575,745,830,1429,146,0,3116,1530,1586,2917,199,0
2021-01-06,CAL,1074,547,527,1014,60,0,4190,2077,2113,3931,259,0
2021-01-07,CAL,2880,1426,1454,2579,301,0,7070,3503,3567,6510,560,0
2021-01-08,CAL,1290,632,658,1171,119,0,8360,4135,4225,7681,679,0
2021-01-09,CAL,1781,896,885,1540,241,0,10141,5031,5110,9221,920,0
2021-01-10,CAL,1096,566,530,826,270,0,11237,5597,5640,10047,1190,0
2021-01-11,CAL,1544,791,753,1230,270,44,12781,6388,6393,11277,1460,44
2021-01-12,CAL,900,440,460,753,128,19,13681,6828,6853,12030,1588,63
2020-12-27,CAM,719,422,297,711,8,0,719,422,297,711,8,0
2020-12-31,CAM,1488,809,679,1332,155,1,2207,1231,976,2043,163,1
2021-01-01,CAM,917,505,412,841,76,0,3124,1736,1388,2884,239,1
2021-01-02,CAM,3668,1961,1707,3388,280,0,6792,3697,3095,6272,519,1
2021-01-03,CAM,3831,2005,1826,3494,337,0,10623,5702,4921,9766,856,1
2021-01-04,CAM,5823,2959,2864,5234,589,0,16446,8661,7785,15000,1445,1
2021-01-05,CAM,7162,3592,3570,6262,814,86,23608,12253,11355,21262,2259,87
2021-01-06,CAM,7661,3758,3903,6350,1007,304,31269,16011,15258,27612,3266,391
2021-01-07,CAM,8928,4191,4737,7248,1352,328,40197,20202,19995,34860,4618,719
2021-01-08,CAM,10446,4968,5478,7873,2361,212,50643,25170,25473,42733,6979,931
2021-01-09,CAM,10515,5003,5512,8309,1937,269,61158,30173,30985,51042,8916,1200
2021-01-10,CAM,8141,3729,4412,6617,1413,111,69299,33902,35397,57659,10329,1311
2021-01-11,CAM,3967,1808,2159,2666,1147,154,73266,35710,37556,60325,11476,1465
2021-01-12,CAM,5294,2608,2686,3804,1064,426,78560,38318,40242,64129,12540,1891
2020-12-27,EMR,963,368,595,582,355,26,963,368,595,582,355,26
2020-12-31,EMR,2102,741,1361,1371,411,320,3065,1109,1956,1953,766,346
2021-01-02,EMR,2269,888,1381,1874,245,150,5334,1997,3337,3827,1011,496
2021-01-03,EMR,2728,934,1794,2233,325,170,8062,2931,5131,6060,1336,666
2021-01-04,EMR,7198,2496,4702,5170,1605,423,15260,5427,9833,11230,2941,1089
2021-01-05,EMR,9061,3076,5985,5667,2829,565,24321,8503,15818,16897,5770,1654
2021-01-06,EMR,8039,2877,5162,5142,2413,484,32360,11380,20980,22039,8183,2138
2021-01-07,EMR,9905,3295,6610,6047,3109,749,42265,14675,27590,28086,11292,2887
2021-01-08,EMR,10343,3441,6902,6233,3358,752,52608,18116,34492,34319,14650,3639
2021-01-09,EMR,9002,3121,5881,5539,2886,577,61610,21237,40373,39858,17536,4216
2021-01-10,EMR,6519,2447,4072,3762,2411,346,68129,23684,44445,43620,19947,4562
2021-01-11,EMR,8567,3050,5517,4682,3042,843,76696,26734,49962,48302,22989,5405
2021-01-12,EMR,8194,2686,5508,4442,2517,1235,84890,29420,55470,52744,25506,6640
2020-12-27,FVG,265,149,116,265,0,0,265,149,116,265,0,0
2020-12-30,FVG,629,250,379,589,40,0,894,399,495,854,40,0
2020-12-31,FVG,1054,384,670,968,86,0,1948,783,1165,1822,126,0
2021-01-02,FVG,1212,469,743,1105,107,0,3160,1252,1908,2927,233,0
2021-01-03,FVG,311,121,190,237,74,0,3471,1373,2098,3164,307,0
2021-01-04,FVG,1509,559,950,1315,194,0,4980,1932,3048,4479,501,0
2021-01-05,FVG,1622,534,1088,1243,193,186,6602,2466,4136,5722,694,186
2021-01-06,FVG,709,264,445,444,265,0,7311,2730,4581,6166,959,186
2021-01-07,FVG,2088,717,1371,1668,315,105,9399,3447,5952,7834,1274,291
2021-01-08,FVG,2318,746,1572,1552,370,396,11717,4193,7524,9386,1644,687
2021-01-09,FVG,2512,839,1673,1260,663,589,14229,5032,9197,10646,2307,1276
2021-01-10,FVG,2930,917,2013,1501,1186,243,17159,5949,11210,12147,3493,1519
2021-01-11,FVG,1809,588,1221,1295,513,1,18968,6537,12431,13442,4006,1520
2021-01-12,FVG,2247,711,1536,1250,640,357,21215,7248,13967,14692,4646,1877
2020-12-27,LAZ,179,91,88,178,1,0,179,91,88,178,1,0
2020-12-28,LAZ,567,251,316,551,16,0,746,342,404,729,17,0
2020-12-29,LAZ,351,129,222,336,15,0,1097,471,626,1065,32,0
2020-12-30,LAZ,1604,656,948,1523,21,60,2701,1127,1574,2588,53,60
2020-12-31,LAZ,4907,2003,2904,4484,140,283,7608,3130,4478,7072,193,343
2021-01-01,LAZ,3545,1396,2149,3338,138,69,11153,4526,6627,10410,331,412
2021-01-02,LAZ,6728,2624,4104,5999,294,435,17881,7150,10731,16409,625,847
2021-01-03,LAZ,5187,1959,3228,4720,267,200,23068,9109,13959,21129,892,1047
2021-01-04,LAZ,7352,2862,4490,6472,521,359,30420,11971,18449,27601,1413,1406
2021-01-05,LAZ,6763,2576,4187,5645,562,556,37183,14547,22636,33246,1975,1962
2021-01-06,LAZ,4854,1829,3025,4098,454,302,42037,16376,25661,37344,2429,2264
2021-01-07,LAZ,7442,2746,4696,6045,901,496,49479,19122,30357,43389,3330,2760
2021-01-08,LAZ,7205,2685,4520,5637,842,726,56684,21807,34877,49026,4172,3486
2021-01-09,LAZ,6038,2430,3608,4375,971,692,62722,24237,38485,53401,5143,4178
2021-01-10,LAZ,3844,1599,2245,2830,769,245,66566,25836,40730,56231,5912,4423
2021-01-11,LAZ,5442,2050,3392,4096,827,519,72008,27886,44122,60327,6739,4942
2021-01-12,LAZ,4887,1790,3097,3502,865,520,76895,29676,47219,63829,7604,5462
2020-12-27,LIG,135,59,76,102,3,30,135,59,76,102,3,30
2020-12-28,LIG,80,30,50,79,1,0,215,89,126,181,4,30
2020-12-29,LIG,125,33,92,97,7,21,340,122,218,278,11,51
2020-12-30,LIG,12,5,7,12,0,0,352,127,225,290,11,51
2020-12-31,LIG,935,341,594,730,22,183,1287,468,819,1020,33,234
2021-01-01,LIG,144,55,89,133,11,0,1431,523,908,1153,44,234
2021-01-02,LIG,692,246,446,587,105,0,2123,769,1354,1740,149,234
2021-01-03,LIG,693,222,471,617,76,0,2816,991,1825,2357,225,234
2021-01-04,LIG,2633,853,1780,2155,247,231,5449,1844,3605,4512,472,465
2021-01-05,LIG,2878,892,1986,2295,327,256,8327,2736,5591,6807,799,721
2021-01-06,LIG,1655,610,1045,1261,208,186,9982,3346,6636,8068,1007,907
2021-01-07,LIG,3178,1079,2099,2229,502,447,13160,4425,8735,10297,1509,1354
2021-01-08,LIG,2737,967,1770,1986,425,326,15897,5392,10505,12283,1934,1680
2021-01-09,LIG,1332,480,852,858,287,187,17229,5872,11357,13141,2221,1867
2021-01-10,LIG,855,398,457,343,371,141,18084,6270,11814,13484,2592,2008
2021-01-11,LIG,2420,912,1508,1709,519,192,20504,7182,13322,15193,3111,2200
2021-01-12,LIG,1485,532,953,1052,219,214,21989,7714,14275,16245,3330,2414
2020-12-27,LOM,766,457,309,731,23,12,766,457,309,731,23,12
2020-12-28,LOM,391,171,220,338,53,0,1157,628,529,1069,76,12
2020-12-29,LOM,416,172,244,357,59,0,1573,800,773,1426,135,12
2020-12-30,LOM,128,44,84,118,10,0,1701,844,857,1544,145,12
2020-12-31,LOM,665,263,402,639,26,0,2366,1107,1259,2183,171,12
2021-01-01,LOM,24,7,17,24,0,0,2390,1114,1276,2207,171,12
2021-01-02,LOM,200,74,126,192,8,0,2590,1188,1402,2399,179,12
2021-01-03,LOM,835,311,524,803,28,4,3425,1499,1926,3202,207,16
2021-01-04,LOM,6834,2406,4428,6161,499,174,10259,3905,6354,9363,706,190
2021-01-05,LOM,7636,2495,5141,6663,773,200,17895,6400,11495,16026,1479,390
2021-01-06,LOM,7165,2510,4655,5981,1126,58,25060,8910,16150,22007,2605,448
2021-01-07,LOM,10717,3414,7303,8843,1274,600,35777,12324,23453,30850,3879,1048
2021-01-08,LOM,11394,3531,7863,9550,1481,363,47171,15855,31316,40400,5360,1411
2021-01-09,LOM,11986,4422,7564,9234,2516,236,59157,20277,38880,49634,7876,1647
2021-01-10,LOM,10637,4044,6593,8127,2504,6,69794,24321,45473,57761,10380,1653
2021-01-11,LOM,14914,5018,9896,11108,3149,657,84708,29339,55369,68869,13529,2310
2021-01-12,LOM,16650,5669,10981,11717,4085,848,101358,35008,66350,80586,17614,3158
2020-12-27,MAR,200,97,103,188,8,4,200,97,103,188,8,4
2020-12-30,MAR,17,5,12,14,3,0,217,102,115,202,11,4
2020-12-31,MAR,384,173,211,371,13,0,601,275,326,573,24,4
2021-01-02,MAR,515,168,347,485,30,0,1116,443,673,1058,54,4
2021-01-03,MAR,897,348,549,745,152,0,2013,791,1222,1803,206,4
2021-01-04,MAR,1385,533,852,1204,181,0,3398,1324,2074,3007,387,4
2021-01-05,MAR,1502,557,945,1368,134,0,4900,1881,3019,4375,521,4
2021-01-06,MAR,2138,785,1353,1674,357,107,7038,2666,4372,6049,878,111
2021-01-07,MAR,2049,741,1308,1829,220,0,9087,3407,5680,7878,1098,111
2021-01-08,MAR,1572,591,981,1323,224,25,10659,3998,6661,9201,1322,136
2021-01-09,MAR,1711,607,1104,1452,259,0,12370,4605,7765,10653,1581,136
2021-01-10,MAR,1760,705,1055,1498,253,9,14130,5310,8820,12151,1834,145
2021-01-11,MAR,1114,427,687,963,151,0,15244,5737,9507,13114,1985,145
2021-01-12,MAR,938,322,616,755,183,0,16182,6059,10123,13869,2168,145
2020-12-27,MOL,50,20,30,32,1,17,50,20,30,32,1,17
2021-01-04,MOL,308,130,178,292,16,0,358,150,208,324,17,17
2021-01-05,MOL,448,180,268,440,8,0,806,330,476,764,25,17
2021-01-06,MOL,680,257,423,443,56,181,1486,587,899,1207,81,198
2021-01-07,MOL,594,208,386,386,62,146,2080,795,1285,1593,143,344
2021-01-08,MOL,429,140,289,234,75,120,2509,935,1574,1827,218,464
2021-01-09,MOL,449,152,297,214,57,178,2958,1087,1871,2041,275,642
2021-01-10,MOL,269,72,197,82,19,168,3227,1159,2068,2123,294,810
2021-01-11,MOL,557,194,363,190,256,111,3784,1353,2431,2313,550,921
2021-01-12,MOL,336,114,222,131,75,130,4120,1467,2653,2444,625,1051
2020-12-27,PAB,144,65,79,144,0,0,144,65,79,144,0,0
2020-12-28,PAB,0,0,0,0,0,0,144,65,79,144,0,0
2020-12-30,PAB,383,163,220,343,40,0,527,228,299,487,40,0
2020-12-31,PAB,444,203,241,371,73,0,971,431,540,858,113,0
2021-01-02,PAB,66,28,38,66,0,0,1037,459,578,924,113,0
2021-01-04,PAB,453,180,273,375,78,0,1490,639,851,1299,191,0
2021-01-05,PAB,817,287,530,683,134,0,2307,926,1381,1982,325,0
2021-01-06,PAB,60,19,41,40,20,0,2367,945,1422,2022,345,0
2021-01-07,PAB,814,285,529,573,213,28,3181,1230,1951,2595,558,28
2021-01-08,PAB,1426,470,956,828,300,298,4607,1700,2907,3423,858,326
2021-01-09,PAB,310,139,171,55,147,108,4917,1839,3078,3478,1005,434
2021-01-11,PAB,1396,389,1007,693,356,347,6313,2228,4085,4171,1361,781
2021-01-12,PAB,1433,375,1058,670,301,462,7746,2603,5143,4841,1662,1243
2020-12-27,PAT,100,39,61,77,3,20,100,39,61,77,3,20
2020-12-31,PAT,1494,423,1071,811,102,581,1594,462,1132,888,105,601
2021-01-01,PAT,209,49,160,111,11,87,1803,511,1292,999,116,688
2021-01-02,PAT,501,142,359,337,24,140,2304,653,1651,1336,140,828
2021-01-03,PAT,493,159,334,417,11,65,2797,812,1985,1753,151,893
2021-01-04,PAT,824,195,629,490,48,286,3621,1007,2614,2243,199,1179
2021-01-05,PAT,694,233,461,485,52,157,4315,1240,3075,2728,251,1336
2021-01-06,PAT,42,13,29,42,0,0,4357,1253,3104,2770,251,1336
2021-01-07,PAT,1271,310,961,648,70,553,5628,1563,4065,3418,321,1889
2021-01-08,PAT,1489,332,1157,813,150,526,7117,1895,5222,4231,471,2415
2021-01-09,PAT,186,40,146,143,13,30,7303,1935,5368,4374,484,2445
2021-01-10,PAT,78,18,60,52,18,8,7381,1953,5428,4426,502,2453
2021-01-11,PAT,474,128,346,311,55,108,7855,2081,5774,4737,557,2561
2021-01-12,PAT,349,106,243,257,26,66,8204,2187,6017,4994,583,2627
2020-12-27,PIE,908,366,542,757,75,76,908,366,542,757,75,76
2020-12-30,PIE,724,320,404,677,47,0,1632,686,946,1434,122,76
2020-12-31,PIE,3821,1307,2514,3336,352,133,5453,1993,3460,4770,474,209
2021-01-01,PIE,1033,391,642,919,114,0,6486,2384,4102,5689,588,209
2021-01-02,PIE,3529,1130,2399,3069,408,52,10015,3514,6501,8758,996,261
2021-01-03,PIE,3053,964,2089,2705,296,52,13068,4478,8590,11463,1292,313
2021-01-04,PIE,5530,1665,3865,4562,735,233,18598,6143,12455,16025,2027,546
2021-01-05,PIE,5353,1600,3753,4352,722,279,23951,7743,16208,20377,2749,825
2021-01-06,PIE,3102,1104,1998,2362,426,314,27053,8847,18206,22739,3175,1139
2021-01-07,PIE,5331,1720,3611,4133,877,321,32384,10567,21817,26872,4052,1460
2021-01-08,PIE,5509,1753,3756,4074,1026,409,37893,12320,25573,30946,5078,1869
2021-01-09,PIE,6140,2168,3972,4474,1123,543,44033,14488,29545,35420,6201,2412
2021-01-10,PIE,5171,2266,2905,3879,782,510,49204,16754,32450,39299,6983,2922
2021-01-11,PIE,8675,2957,5718,5998,1546,1131,57879,19711,38168,45297,8529,4053
2021-01-12,PIE,9454,3228,6226,6589,1946,919,67333,22939,44394,51886,10475,4972
2020-12-27,PUG,555,279,276,482,11,62,555,279,276,482,11,62
2020-12-31,PUG,1274,618,656,1202,56,16,1829,897,932,1684,67,78
2021-01-01,PUG,179,77,102,179,0,0,2008,974,1034,1863,67,78
2021-01-02,PUG,2903,1278,1625,2789,106,8,4911,2252,2659,4652,173,86
2021-01-03,PUG,1921,907,1014,1797,57,67,6832,3159,3673,6449,230,153
2021-01-04,PUG,4091,1794,2297,3847,199,45,10923,4953,5970,10296,429,198
2021-01-05,PUG,5380,2421,2959,4944,328,108,16303,7374,8929,15240,757,306
2021-01-06,PUG,3548,1467,2081,3099,94,355,19851,8841,11010,18339,851,661
2021-01-07,PUG,5210,2221,2989,4680,315,215,25061,11062,13999,23019,1166,876
2021-01-08,PUG,4780,1984,2796,4208,353,219,29841,13046,16795,27227,1519,1095
2021-01-09,PUG,5061,2337,2724,4529,185,347,34902,15383,19519,31756,1704,1442
2021-01-10,PUG,2143,973,1170,1874,129,140,37045,16356,20689,33630,1833,1582
2021-01-11,PUG,3035,1316,1719,2765,207,63,40080,17672,22408,36395,2040,1645
2021-01-12,PUG,3440,1438,2002,3063,190,187,43520,19110,24410,39458,2230,1832
2020-12-27,SAR,65,34,31,65,0,0,65,34,31,65,0,0
2020-12-28,SAR,65,25,40,65,0,0,130,59,71,130,0,0
2020-12-29,SAR,50,29,21,49,1,0,180,88,92,179,1,0
2020-12-31,SAR,32,16,16,27,5,0,212,104,108,206,6,0
2021-01-01,SAR,30,16,14,30,0,0,242,120,122,236,6,0
2021-01-02,SAR,60,21,39,60,0,0,302,141,161,296,6,0
2021-01-03,SAR,90,36,54,89,1,0,392,177,215,385,7,0
2021-01-04,SAR,573,212,361,552,21,0,965,389,576,937,28,0
2021-01-05,SAR,1247,417,830,1210,37,0,2212,806,1406,2147,65,0
2021-01-06,SAR,1587,539,1048,1474,113,0,3799,1345,2454,3621,178,0
2021-01-07,SAR,3066,1060,2006,2687,379,0,6865,2405,4460,6308,557,0
2021-01-08,SAR,3242,1206,2036,2910,332,0,10107,3611,6496,9218,889,0
2021-01-09,SAR,4001,1406,2595,3192,809,0,14108,5017,9091,12410,1698,0
2021-01-10,SAR,2173,746,1427,1678,495,0,16281,5763,10518,14088,2193,0
2021-01-11,SAR,1179,504,675,687,492,0,17460,6267,11193,14775,2685,0
2021-01-12,SAR,865,408,457,541,324,0,18325,6675,11650,15316,3009,0
2020-12-27,SIC,132,76,56,105,2,25,132,76,56,105,2,25
2020-12-28,SIC,214,128,86,212,2,0,346,204,142,317,4,25
2020-12-29,SIC,235,146,89,235,0,0,581,350,231,552,4,25
2020-12-30,SIC,239,142,97,221,18,0,820,492,328,773,22,25
2020-12-31,SIC,866,469,397,857,9,0,1686,961,725,1630,31,25
2021-01-01,SIC,809,433,376,776,33,0,2495,1394,1101,2406,64,25
2021-01-02,SIC,4962,2593,2369,4662,300,0,7457,3987,3470,7068,364,25
2021-01-03,SIC,4645,2428,2217,4309,336,0,12102,6415,5687,11377,700,25
2021-01-04,SIC,7613,3779,3834,6844,763,6,19715,10194,9521,18221,1463,31
2021-01-05,SIC,10228,4997,5231,8759,1290,179,29943,15191,14752,26980,2753,210
2021-01-06,SIC,6226,3211,3015,5420,800,6,36169,18402,17767,32400,3553,216
2021-01-07,SIC,8653,3989,4664,7236,1205,212,44822,22391,22431,39636,4758,428
2021-01-08,SIC,7504,3466,4038,5982,1336,186,52326,25857,26469,45618,6094,614
2021-01-09,SIC,6708,3144,3564,4675,1709,324,59034,29001,30033,50293,7803,938
2021-01-10,SIC,3073,1350,1723,1642,994,437,62107,30351,31756,51935,8797,1375
2021-01-11,SIC,4740,2051,2689,3200,1220,320,66847,32402,34445,55135,10017,1695
2021-01-12,SIC,2601,1246,1355,1731,692,178,69448,33648,35800,56866,10709,1873
2020-12-27,TOS,620,267,353,581,9,30,620,267,353,581,9,30
2020-12-30,TOS,302,96,206,34,6,262,922,363,559,615,15,292
2020-12-31,TOS,761,188,573,97,4,660,1683,551,1132,712,19,952
2021-01-01,TOS,2365,785,1580,1714,2,649,4048,1336,2712,2426,21,1601
2021-01-02,TOS,3493,1095,2398,2678,15,800,7541,2431,5110,5104,36,2401
2021-01-03,TOS,3366,1066,2300,2564,8,794,10907,3497,7410,7668,44,3195
2021-01-04,TOS,5049,1888,3161,4090,32,927,15956,5385,10571,11758,76,4122
2021-01-05,TOS,5236,1752,3484,4346,11,879,21192,7137,14055,16104,87,5001
2021-01-06,TOS,4466,1440,3026,3964,10,492,25658,8577,17081,20068,97,5493
2021-01-07,TOS,5983,1741,4242,5298,30,655,31641,10318,21323,25366,127,6148
2021-01-08,TOS,5949,1637,4312,5359,39,551,37590,11955,25635,30725,166,6699
2021-01-09,TOS,4480,1594,2886,3778,144,558,42070,13549,28521,34503,310,7257
2021-01-10,TOS,2910,1084,1826,2430,137,343,44980,14633,30347,36933,447,7600
2021-01-11,TOS,4997,1650,3347,4348,202,447,49977,16283,33694,41281,649,8047
2021-01-12,TOS,3417,1343,2074,2901,281,235,53394,17626,35768,44182,930,8282
2020-12-27,UMB,144,76,68,122,5,17,144,76,68,122,5,17
2020-12-31,UMB,251,89,162,250,1,0,395,165,230,372,6,17
2021-01-01,UMB,281,110,171,278,3,0,676,275,401,650,9,17
2021-01-02,UMB,304,120,184,303,1,0,980,395,585,953,10,17
2021-01-03,UMB,270,110,160,270,0,0,1250,505,745,1223,10,17
2021-01-04,UMB,807,381,426,806,1,0,2057,886,1171,2029,11,17
2021-01-05,UMB,856,425,431,856,0,0,2913,1311,1602,2885,11,17
2021-01-06,UMB,846,323,523,846,0,0,3759,1634,2125,3731,11,17
2021-01-07,UMB,1406,405,1001,906,6,494,5165,2039,3126,4637,17,511
2021-01-08,UMB,1180,365,815,953,12,215,6345,2404,3941,5590,29,726
2021-01-09,UMB,1673,479,1194,894,14,765,8018,2883,5135,6484,43,1491
2021-01-10,UMB,983,271,712,739,1,243,9001,3154,5847,7223,44,1734
2021-01-11,UMB,1206,341,865,877,33,296,10207,3495,6712,8100,77,2030
2021-01-12,UMB,738,214,524,328,263,147,10945,3709,7236,8428,340,2177
2020-12-27,VDA,20,9,11,20,0,0,20,9,11,20,0,0
2020-12-31,VDA,18,4,14,18,0,0,38,13,25,38,0,0
2021-01-02,VDA,6,5,1,0,0,6,44,18,26,38,0,6
2021-01-04,VDA,142,59,83,142,0,0,186,77,109,180,0,6
2021-01-05,VDA,150,54,96,139,0,11,336,131,205,319,0,17
2021-01-06,VDA,66,34,32,48,0,18,402,165,237,367,0,35
2021-01-07,VDA,279,113,166,273,0,6,681,278,403,640,0,41
2021-01-08,VDA,299,130,169,275,0,24,980,408,572,915,0,65
2021-01-09,VDA,443,199,244,414,0,29,1423,607,816,1329,0,94
2021-01-10,VDA,220,71,149,200,0,20,1643,678,965,1529,0,114
2021-01-11,VDA,326,112,214,295,0,31,1969,790,1179,1824,0,145
2021-01-12,VDA,301,72,229,289,0,12,2270,862,1408,2113,0,157
2020-12-27,VEN,880,395,485,879,1,0,880,395,485,879,1,0
2020-12-30,VEN,698,245,453,621,38,39,1578,640,938,1500,39,39
2020-12-31,VEN,3160,1026,2134,2855,100,205,4738,1666,3072,4355,139,244
2021-01-01,VEN,1521,470,1051,1510,10,1,6259,2136,4123,5865,149,245
2021-01-02,VEN,5711,1758,3953,4905,263,543,11970,3894,8076,10770,412,788
2021-01-03,VEN,5065,1530,3535,4511,304,250,17035,5424,11611,15281,716,1038
2021-01-04,VEN,6604,2001,4603,5282,465,857,23639,7425,16214,20563,1181,1895
2021-01-05,VEN,7302,2173,5129,5516,670,1116,30941,9598,21343,26079,1851,3011
2021-01-06,VEN,8070,2365,5705,6511,759,800,39011,11963,27048,32590,2610,3811
2021-01-07,VEN,8088,2255,5833,5371,919,1798,47099,14218,32881,37961,3529,5609
2021-01-08,VEN,9289,2798,6491,6140,1391,1758,56388,17016,39372,44101,4920,7367
2021-01-09,VEN,7876,2512,5364,5051,1290,1535,64264,19528,44736,49152,6210,8902
2021-01-10,VEN,4999,1656,3343,3442,1226,331,69263,21184,48079,52594,7436,9233
2021-01-11,VEN,6483,1908,4575,3467,1456,1560,75746,23092,52654,56061,8892,10793
2021-01-12,VEN,4694,1350,3344,2238,959,1497,80440,24442,55998,58299,9851,12290
